,total,LMICs,LMICs_perc,HICs,Unknown,Avg BC,Avg DC,Avg CC
0,5931,503,0.08480863260832912,5428,0,67028.30284623573,10.528241443264205,0.07541106398404657
1,30,2,0.06666666666666667,28,0,49436.3412439625,11.733333333333333,0.07784513101554671
2,24,2,0.08333333333333333,22,0,139803.63140745505,15.375,0.09271391938438593
3,18,1,0.05555555555555555,17,0,2558.17064486546,7.166666666666667,0.06480540829452536
4,17,0,0.0,17,0,5883.153718226529,7.470588235294118,0.06383288236353915
5,25,3,0.12,22,0,20083.08983844381,6.04,0.03576791303258873
6,12,0,0.0,12,0,0.0,3.5,0.060283900280173046
7,23,1,0.043478260869565216,22,0,23770.524622283774,10.391304347826088,0.08663621242565822
8,34,1,0.029411764705882353,33,0,1956.877575401466,9.588235294117647,0.08262231771148151
9,44,5,0.11363636363636363,39,0,43114.51898627105,9.909090909090908,0.08952047868671514
10,29,6,0.20689655172413793,23,0,26246.439657278832,6.068965517241379,0.06359099367792548
11,31,2,0.06451612903225806,29,0,106901.2147476437,9.129032258064516,0.07714176364827427
12,24,1,0.041666666666666664,23,0,18443.39957019813,7.041666666666667,0.06405529445927359
13,16,1,0.0625,15,0,39380.14062170067,16.875,0.06363843016222553
14,37,2,0.05405405405405406,35,0,91290.54693585285,10.567567567567568,0.06991258236363743
15,12,2,0.16666666666666666,10,0,21593.54581511783,12.083333333333334,0.10004268486961991
16,30,5,0.16666666666666666,25,0,37207.82202693469,10.3,0.0860414489870411
17,30,2,0.06666666666666667,28,0,227305.08507646777,12.1,0.08368028634616162
18,15,0,0.0,15,0,104832.79196922526,15.533333333333333,0.07630314146057807
19,50,2,0.04,48,0,20772.040954566346,14.12,0.09570503316540434
20,26,2,0.07692307692307693,24,0,64633.000553968974,8.076923076923077,0.08780250615601556
21,26,2,0.07692307692307693,24,0,36344.477003234424,14.653846153846153,0.10665828332422601
22,34,3,0.08823529411764706,31,0,75854.76922283878,10.264705882352942,0.08895872092723109
23,38,2,0.05263157894736842,36,0,96132.58393263501,13.263157894736842,0.08038250614425399
24,34,2,0.058823529411764705,32,0,33554.60517053586,9.735294117647058,0.05280020408599315
25,13,4,0.3076923076923077,9,0,20358.0,6.6923076923076925,0.0618924627654519
26,14,1,0.07142857142857142,13,0,47250.716211814484,12.642857142857142,0.10486790291211438
27,31,3,0.0967741935483871,28,0,133243.9315264539,9.129032258064516,0.06492501886633127
28,43,1,0.023255813953488372,42,0,32508.81833049944,6.4186046511627906,0.07527825599729608
29,26,1,0.038461538461538464,25,0,3441.2004268762976,11.423076923076923,0.06844688179008054
30,23,3,0.13043478260869565,20,0,37571.136059454584,8.26086956521739,0.0764897612306367
31,24,4,0.16666666666666666,20,0,63174.029104907044,9.375,0.07055629447711755
32,19,0,0.0,19,0,16263.685908498825,11.68421052631579,0.0785964057467845
33,36,4,0.1111111111111111,32,0,16106.735039895433,7.333333333333333,0.08068899166675923
34,23,1,0.043478260869565216,22,0,72475.91531643865,10.521739130434783,0.08045519753483492
35,26,1,0.038461538461538464,25,0,38056.46545386962,7.846153846153846,0.09253326371754032
36,17,4,0.23529411764705882,13,0,41256.4393766121,5.647058823529412,0.07236662972219123
37,25,6,0.24,19,0,95560.22141951784,10.48,0.07313832761721129
38,26,1,0.038461538461538464,25,0,22385.019140751796,12.807692307692308,0.07040254496366496
39,23,2,0.08695652173913043,21,0,3836.710144927536,5.478260869565218,0.06614602509902186
40,28,2,0.07142857142857142,26,0,72609.16905297898,6.928571428571429,0.06903369676028355
41,10,2,0.2,8,0,38246.45644449036,4.4,0.03656813873281407
42,22,4,0.18181818181818182,18,0,17849.087774902076,18.59090909090909,0.06901656055813643
43,17,0,0.0,17,0,0.0,7.0588235294117645,0.05208117951671636
44,11,1,0.09090909090909091,10,0,2.918450801081867,7.181818181818182,0.08413534973514793
45,15,3,0.2,12,0,403.8628329865724,14.4,0.07784819583882273
46,26,3,0.11538461538461539,23,0,25018.82350544533,8.461538461538462,0.072258055577194
47,18,2,0.1111111111111111,16,0,41301.79697794638,9.555555555555555,0.08171296188268881
48,16,4,0.25,12,0,24250.18757605718,9.6875,0.10145429101531397
49,34,2,0.058823529411764705,32,0,32938.05014205672,8.676470588235293,0.06704810562125008
50,25,4,0.16,21,0,65998.47179837368,8.08,0.07229698519289203
51,27,5,0.18518518518518517,22,0,459691.6838366193,25.925925925925927,0.10120710084066051
52,36,6,0.16666666666666666,30,0,407408.07416507305,15.75,0.07871978204790411
53,12,1,0.08333333333333333,11,0,20852.82491832665,6.5,0.07588394899688002
54,26,2,0.07692307692307693,24,0,46098.60018352664,5.615384615384615,0.06832172550731548
55,23,1,0.043478260869565216,22,0,0.42391304347826086,4.391304347826087,0.046774014921927384
56,14,2,0.14285714285714285,12,0,364579.2214492143,26.071428571428573,0.10076527517286347
57,42,1,0.023809523809523808,41,0,62733.02308015405,6.523809523809524,0.0774321645895003
58,17,1,0.058823529411764705,16,0,53667.2007741226,12.941176470588236,0.09018455829618609
59,37,1,0.02702702702702703,36,0,45156.75615903824,6.621621621621622,0.06873035464098315
60,20,2,0.1,18,0,54497.150556372806,10.4,0.09680257436022202
61,17,1,0.058823529411764705,16,0,77456.1242081712,10.117647058823529,0.05419961927007492
62,23,1,0.043478260869565216,22,0,48261.1417911747,11.826086956521738,0.07510430725952567
63,22,0,0.0,22,0,60424.11128032486,10.227272727272727,0.05714938512307444
64,22,3,0.13636363636363635,19,0,30825.401078754538,7.2272727272727275,0.06443641127121681
65,17,3,0.17647058823529413,14,0,92025.57692038665,10.294117647058824,0.10314482574393617
66,34,3,0.08823529411764706,31,0,271585.12541609333,11.852941176470589,0.06329362296026204
67,19,1,0.05263157894736842,18,0,267505.11728518654,14.736842105263158,0.08223415932910705
68,38,4,0.10526315789473684,34,0,96891.10171601697,8.973684210526315,0.0661652049642432
69,13,1,0.07692307692307693,12,0,46969.00348033643,16.0,0.07798143369631481
70,20,2,0.1,18,0,24893.633918919753,7.95,0.05978784404719915
71,11,0,0.0,11,0,0.0,8.181818181818182,0.08636211074546515
72,13,0,0.0,13,0,12459.423162355171,9.153846153846153,0.0811322844216348
73,26,0,0.0,26,0,29062.19776244011,7.153846153846154,0.07240499399974835
74,23,0,0.0,23,0,70469.07350055897,10.0,0.07781543451921866
75,15,0,0.0,15,0,54035.32303004338,9.133333333333333,0.06343665705452314
76,18,1,0.05555555555555555,17,0,86940.30322556199,6.111111111111111,0.06908631422862131
77,42,6,0.14285714285714285,36,0,340319.56397575955,12.5,0.08189456473204076
78,25,5,0.2,20,0,10650.970342505188,9.16,0.07840084032278676
79,28,2,0.07142857142857142,26,0,25935.550170599836,9.678571428571429,0.0820271766340047
80,23,2,0.08695652173913043,21,0,301468.2563976838,17.304347826086957,0.0869130661985293
81,22,0,0.0,22,0,17456.35006274039,7.863636363636363,0.07006019088726173
82,25,5,0.2,20,0,141866.7044239865,14.08,0.08550383070671516
83,38,8,0.21052631578947367,30,0,55552.676219650406,9.447368421052632,0.06852969252968315
84,24,2,0.08333333333333333,22,0,134757.26492043288,15.958333333333334,0.09655091642989222
85,14,1,0.07142857142857142,13,0,39113.01245938091,14.714285714285714,0.09739793671372932
86,30,4,0.13333333333333333,26,0,7361.437134357721,8.3,0.07715543751493258
87,31,4,0.12903225806451613,27,0,95397.39096565492,11.96774193548387,0.08577785506391145
88,22,2,0.09090909090909091,20,0,73827.36208104361,13.5,0.0736089618598254
89,18,1,0.05555555555555555,17,0,99413.36309308832,13.722222222222221,0.07953701776289245
90,13,0,0.0,13,0,94749.29161763267,27.53846153846154,0.0950277592868316
91,29,1,0.034482758620689655,28,0,32518.700524452717,9.310344827586206,0.061463686144015234
92,20,1,0.05,19,0,71702.4699017948,18.5,0.08810866670759007
93,33,6,0.18181818181818182,27,0,54824.78298174758,9.030303030303031,0.07636495489608587
94,61,3,0.04918032786885246,58,0,279461.07462063985,13.131147540983607,0.0870303985115524
95,31,1,0.03225806451612903,30,0,51861.000130060485,10.03225806451613,0.08129584560180382
96,16,2,0.125,14,0,3860.0258312102833,8.625,0.08625584991248667
97,33,2,0.06060606060606061,31,0,26297.73810415558,11.424242424242424,0.07925335865270473
98,20,2,0.1,18,0,8870.845674486838,8.8,0.06975682696341315
99,16,1,0.0625,15,0,145753.2280078861,9.625,0.08220662590954014
100,19,1,0.05263157894736842,18,0,55748.74047925364,11.526315789473685,0.08455782771000009
101,29,5,0.1724137931034483,24,0,17189.795640833552,5.655172413793103,0.06444102130308334
102,20,4,0.2,16,0,62754.70666155049,22.8,0.07919372044817766
103,21,3,0.14285714285714285,18,0,12609.144922194935,6.523809523809524,0.06314831664263394
104,21,3,0.14285714285714285,18,0,11473.6687622653,7.0476190476190474,0.06800896669842171
105,27,0,0.0,27,0,54504.63147381685,8.25925925925926,0.06276716128047097
106,38,4,0.10526315789473684,34,0,108236.89400187551,8.68421052631579,0.08818908506365328
107,14,0,0.0,14,0,32139.18333613319,6.142857142857143,0.06225783647849609
108,12,0,0.0,12,0,101331.99747683387,15.833333333333334,0.0821011458727668
109,16,1,0.0625,15,0,31313.115641558674,9.6875,0.07038681150408771
110,13,0,0.0,13,0,34785.7762856487,18.076923076923077,0.06691305378865994
111,21,2,0.09523809523809523,19,0,7526.927685540146,8.523809523809524,0.07797510534044487
112,19,4,0.21052631578947367,15,0,14924.83717632878,7.368421052631579,0.07149248694152432
113,16,1,0.0625,15,0,22191.038722557325,8.0625,0.08266167430381575
114,16,0,0.0,16,0,32068.30891445623,6.125,0.08765693669017144
115,11,1,0.09090909090909091,10,0,0.0,7.7272727272727275,0.047699962899766406
116,25,2,0.08,23,0,56469.3289747312,7.2,0.052052736524303374
117,21,2,0.09523809523809523,19,0,8402.0,7.476190476190476,0.07166992234377241
118,29,3,0.10344827586206896,26,0,189118.2264128935,11.89655172413793,0.08384559082665108
119,18,2,0.1111111111111111,16,0,55408.56398996279,9.61111111111111,0.09187375964809835
120,52,8,0.15384615384615385,44,0,72270.83281312551,13.038461538461538,0.10082753448435602
121,27,3,0.1111111111111111,24,0,10701.947098521163,6.37037037037037,0.07590408776640943
122,21,0,0.0,21,0,66667.1103313655,12.238095238095237,0.07153461471170755
123,12,1,0.08333333333333333,11,0,8875.612829593967,18.416666666666668,0.06430767238408029
124,31,2,0.06451612903225806,29,0,107425.94884526536,8.741935483870968,0.0813045409914223
125,26,3,0.11538461538461539,23,0,10620.761024677557,8.076923076923077,0.06316431322208374
126,19,3,0.15789473684210525,16,0,59344.38435583277,9.31578947368421,0.06273942181992656
127,24,2,0.08333333333333333,22,0,37665.291556600314,7.0,0.08215996181057074
128,21,1,0.047619047619047616,20,0,264986.8481232651,12.80952380952381,0.04608174946745735
129,16,1,0.0625,15,0,24806.733333333334,8.75,0.07794446678222215
130,13,2,0.15384615384615385,11,0,0.0,3.4615384615384617,0.03710880616624705
131,20,0,0.0,20,0,23745.576079280876,9.7,0.08402175641929799
132,22,2,0.09090909090909091,20,0,378356.7380564378,12.227272727272727,0.07582177901258325
133,15,4,0.26666666666666666,11,0,33389.09447207106,9.666666666666666,0.07026743736430777
134,26,0,0.0,26,0,67806.4784232732,13.346153846153847,0.07261481457863382
135,15,2,0.13333333333333333,13,0,103838.93971119588,15.733333333333333,0.10076842239450541
136,33,4,0.12121212121212122,29,0,31825.236566300857,8.909090909090908,0.0681459172868486
137,18,1,0.05555555555555555,17,0,60258.44113822759,11.777777777777779,0.08933684448375767
138,17,5,0.29411764705882354,12,0,93801.19945938433,11.941176470588236,0.08591471184911811
139,13,1,0.07692307692307693,12,0,2387.9736968475404,18.0,0.09816157517694897
140,11,1,0.09090909090909091,10,0,97107.03894379974,9.454545454545455,0.07508411732260085
141,11,2,0.18181818181818182,9,0,54769.01572373624,28.09090909090909,0.09909249456752946
142,18,0,0.0,18,0,128921.71519356687,15.444444444444445,0.0826646988026338
143,45,5,0.1111111111111111,40,0,52696.280510774275,15.2,0.08819822234501891
144,16,3,0.1875,13,0,12777.95399683565,8.3125,0.05740965017546694
145,25,2,0.08,23,0,0.0,10.96,0.06786027586596827
146,13,0,0.0,13,0,33352.83836446611,10.076923076923077,0.10013242526400058
147,12,1,0.08333333333333333,11,0,19.83601985553188,6.0,0.06247241624279764
148,27,1,0.037037037037037035,26,0,10732.086708299463,5.62962962962963,0.059593317956586976
149,42,5,0.11904761904761904,37,0,84909.35853939726,15.69047619047619,0.08469919898480129
150,28,2,0.07142857142857142,26,0,24553.27238145389,12.142857142857142,0.06901249438953538
151,22,2,0.09090909090909091,20,0,19560.588393362475,6.181818181818182,0.07442649384069919
152,51,6,0.11764705882352941,45,0,56057.0789415903,8.254901960784315,0.07952455476042201
153,16,1,0.0625,15,0,74308.57354054828,12.9375,0.08714832699312916
154,18,2,0.1111111111111111,16,0,40904.39119150458,7.888888888888889,0.07560169706835289
155,17,2,0.11764705882352941,15,0,11553.765182141025,11.117647058823529,0.08007515199766906
156,14,0,0.0,14,0,4580.172221402843,7.785714285714286,0.08237122813018082
157,40,4,0.1,36,0,113475.7918118217,10.8,0.08017658768732137
158,16,0,0.0,16,0,64988.69497471949,8.5625,0.07957208672433617
159,15,1,0.06666666666666667,14,0,30887.808132942195,8.066666666666666,0.07299485213498239
160,15,0,0.0,15,0,148604.66134659393,21.733333333333334,0.05028231013010538
161,12,0,0.0,12,0,0.0,8.333333333333334,0.10094247038092974
162,19,1,0.05263157894736842,18,0,101154.43430583301,23.473684210526315,0.0865312129080219
163,30,1,0.03333333333333333,29,0,48946.76665795287,9.1,0.06729501832288111
164,20,0,0.0,20,0,11.074619894244133,8.15,0.07652838540497024
165,25,0,0.0,25,0,45989.19380627515,13.56,0.07683183799965831
166,18,1,0.05555555555555555,17,0,35015.82319232484,6.166666666666667,0.06900652136584895
167,14,2,0.14285714285714285,12,0,21970.76946908101,10.857142857142858,0.08676684877656336
168,19,0,0.0,19,0,263859.67672912934,14.052631578947368,0.08912097382935884
169,16,0,0.0,16,0,77290.67673378525,16.0625,0.11342100575250513
170,48,3,0.0625,45,0,53863.434288189164,10.083333333333334,0.06821478911487054
171,20,0,0.0,20,0,13103.222470283883,5.4,0.06433843720895926
172,34,3,0.08823529411764706,31,0,6613.168275685624,13.647058823529411,0.07925147786435853
173,21,1,0.047619047619047616,20,0,13921.053020512747,6.571428571428571,0.05977057469153814
174,17,1,0.058823529411764705,16,0,45895.89896664588,11.176470588235293,0.08920095798142358
175,19,0,0.0,19,0,327713.1565006564,12.31578947368421,0.10256396273875514
176,18,2,0.1111111111111111,16,0,192221.3125978917,13.166666666666666,0.07877528476688063
177,17,4,0.23529411764705882,13,0,14880.251119749537,9.529411764705882,0.04276418805317014
178,16,3,0.1875,13,0,18478.17822604811,10.0,0.08635153402053664
179,24,3,0.125,21,0,8761.35703910817,8.541666666666666,0.0840774545588292
180,17,3,0.17647058823529413,14,0,20264.251881076587,6.647058823529412,0.07879301288799462
181,12,1,0.08333333333333333,11,0,73025.85408936966,21.916666666666668,0.09187438618643302
182,25,6,0.24,19,0,10858.165726629446,6.88,0.06516430968242796
183,22,3,0.13636363636363635,19,0,105943.84892230635,18.40909090909091,0.07682682962140468
184,17,0,0.0,17,0,24703.431309876858,10.117647058823529,0.08816918075202076
185,14,0,0.0,14,0,6306.190476190476,10.357142857142858,0.09127463350000266
186,17,2,0.11764705882352941,15,0,8576.62432670018,6.0588235294117645,0.08227067698443505
187,21,1,0.047619047619047616,20,0,2050.64897130789,7.619047619047619,0.05787210747899035
188,11,2,0.18181818181818182,9,0,0.11363636363636363,8.0,0.07188873919259743
189,16,0,0.0,16,0,33528.835266056645,9.5,0.08449548192153251
190,28,1,0.03571428571428571,27,0,28020.195538037715,13.142857142857142,0.0714365552408784
191,16,1,0.0625,15,0,54213.10001135139,7.625,0.08679186533520368
192,23,2,0.08695652173913043,21,0,83329.13683994659,10.304347826086957,0.08977047720496914
193,13,1,0.07692307692307693,12,0,339.1538461538113,5.615384615384615,0.05385052918227304
194,11,3,0.2727272727272727,8,0,60625.07177929484,12.272727272727273,0.06459012151255267
195,12,3,0.25,9,0,0.25,3.0833333333333335,0.027049598451192067
196,32,4,0.125,28,0,38235.084515321934,6.78125,0.0587859510761021
197,47,6,0.1276595744680851,41,0,18637.8393956606,11.148936170212766,0.08426457133898196
198,39,1,0.02564102564102564,38,0,385708.9843023605,18.666666666666668,0.09322114836930694
199,18,1,0.05555555555555555,17,0,71226.25996237603,21.61111111111111,0.08586644723369309
200,23,2,0.08695652173913043,21,0,7239.309486825368,7.826086956521739,0.08005691484996837
201,12,0,0.0,12,0,137072.0048963733,10.416666666666666,0.061381709274434
202,13,2,0.15384615384615385,11,0,44085.67651153194,6.3076923076923075,0.05636835245132053
203,17,2,0.11764705882352941,15,0,79991.50730410854,7.294117647058823,0.07446665950281707
204,12,2,0.16666666666666666,10,0,0.5,9.583333333333334,0.06393945901090281
205,18,0,0.0,18,0,34205.067382645044,10.666666666666666,0.06894024266162753
206,30,0,0.0,30,0,31233.092527575245,10.6,0.06865088318562604
207,23,2,0.08695652173913043,21,0,50693.87473891878,11.782608695652174,0.07919245334785438
208,21,2,0.09523809523809523,19,0,206364.53406125368,23.714285714285715,0.06794009509196279
209,18,3,0.16666666666666666,15,0,179683.07167241184,10.166666666666666,0.06497901388515372
210,12,1,0.08333333333333333,11,0,225.8475595312714,7.083333333333333,0.07031661592280888
211,10,0,0.0,10,0,577012.874978042,20.2,0.10945510679232347
212,18,2,0.1111111111111111,16,0,145500.9849850969,8.666666666666666,0.08906674072795938
213,15,1,0.06666666666666667,14,0,221.7865986780226,15.333333333333334,0.10741591917930751
214,16,2,0.125,14,0,120735.97283516404,10.3125,0.0725056700490112
215,12,1,0.08333333333333333,11,0,271110.2344110163,20.333333333333332,0.10850226825969848
216,28,2,0.07142857142857142,26,0,5003.5456240860285,7.714285714285714,0.063437754292307
217,19,1,0.05263157894736842,18,0,28783.10264091457,6.947368421052632,0.05730304692610715
218,12,1,0.08333333333333333,11,0,0.0,25.333333333333332,0.08593139659131477
219,22,2,0.09090909090909091,20,0,10062.31692353841,9.136363636363637,0.07749504453207327
220,17,0,0.0,17,0,108145.05592554079,18.0,0.08689528481066756
221,13,2,0.15384615384615385,11,0,10295.764279441875,11.153846153846153,0.09630791995782542
222,15,0,0.0,15,0,62281.50180206932,8.933333333333334,0.0825055660283904
223,13,0,0.0,13,0,6228.631370122835,10.23076923076923,0.0826292323606439
224,14,0,0.0,14,0,71475.77053675044,11.928571428571429,0.07450957246062936
225,28,1,0.03571428571428571,27,0,59517.45476721372,13.464285714285714,0.07420003823148776
226,29,3,0.10344827586206896,26,0,114144.27941239253,8.137931034482758,0.07678633380150925
227,11,1,0.09090909090909091,10,0,8688.639466093662,9.0,0.10504529157351693
228,16,1,0.0625,15,0,15135.204878950553,10.25,0.07909978922278678
229,26,1,0.038461538461538464,25,0,29989.45531231312,9.576923076923077,0.07372047585377295
230,14,1,0.07142857142857142,13,0,82918.08565020848,8.642857142857142,0.0903820713340356
231,49,4,0.08163265306122448,45,0,228948.2949377286,13.285714285714286,0.08909106505657707
232,16,1,0.0625,15,0,5516.0625,6.0,0.06589614764667001
233,15,1,0.06666666666666667,14,0,7171.893306607755,6.733333333333333,0.06273774113986043
234,12,0,0.0,12,0,166313.28222405163,11.333333333333334,0.0905456396374724
235,30,1,0.03333333333333333,29,0,28536.03087020789,10.166666666666666,0.07115100776816033
236,29,1,0.034482758620689655,28,0,5605.237970495976,8.517241379310345,0.0798651482725488
237,12,0,0.0,12,0,34076.928672716684,5.666666666666667,0.09015000581896877
238,38,4,0.10526315789473684,34,0,201777.9257956415,12.210526315789474,0.09017150771337573
239,34,4,0.11764705882352941,30,0,203855.6780406178,10.382352941176471,0.0907624931620424
240,13,2,0.15384615384615385,11,0,22693.028325902123,7.538461538461538,0.10007782003410573
241,12,0,0.0,12,0,109909.01453154623,19.083333333333332,0.08182975567903393
242,31,1,0.03225806451612903,30,0,9781.124661914437,5.709677419354839,0.0701529387260246
243,23,1,0.043478260869565216,22,0,103024.20019776483,12.217391304347826,0.0938673362783321
244,16,2,0.125,14,0,52377.83731407489,8.8125,0.060745333783621284
245,18,0,0.0,18,0,162.56893994963966,19.055555555555557,0.06546124920521496
246,12,1,0.08333333333333333,11,0,66824.17308799988,6.083333333333333,0.04940151298661314
247,27,1,0.037037037037037035,26,0,229783.59042317487,13.185185185185185,0.07668753108957045
248,16,1,0.0625,15,0,370062.0445701308,27.6875,0.09501062835410089
249,12,0,0.0,12,0,17831.035261792375,8.5,0.05662801236063166
250,15,1,0.06666666666666667,14,0,51455.97542963414,10.066666666666666,0.07442449643866943
251,27,3,0.1111111111111111,24,0,7920.14664584896,6.111111111111111,0.06836266752538427
252,12,1,0.08333333333333333,11,0,260351.36076993108,13.75,0.05395627253622848
253,20,0,0.0,20,0,12593.638562498341,8.0,0.07006677954825755
254,45,3,0.06666666666666667,42,0,46684.1006477494,8.8,0.06914630250757126
255,19,1,0.05263157894736842,18,0,9277.8217930463,11.368421052631579,0.09486059227984138
256,14,0,0.0,14,0,63977.875545396106,14.428571428571429,0.1028847176688986
257,35,4,0.11428571428571428,31,0,6447.072620137349,10.657142857142857,0.08952279106685132
258,15,1,0.06666666666666667,14,0,302307.960825878,13.333333333333334,0.07583237774570041
259,25,2,0.08,23,0,7930.07855723217,7.56,0.07880773508602136
260,21,1,0.047619047619047616,20,0,82564.76614084223,16.571428571428573,0.09060284675359369
261,36,4,0.1111111111111111,32,0,46083.96297726678,9.444444444444445,0.07545445590001358
262,20,2,0.1,18,0,40604.667407165776,11.8,0.0767778203356813
263,11,1,0.09090909090909091,10,0,2566.376516244358,9.545454545454545,0.09750199080236403
264,33,2,0.06060606060606061,31,0,149863.2308110632,12.93939393939394,0.07772833516030388
265,14,3,0.21428571428571427,11,0,0.0,4.428571428571429,0.08102588921828076
266,14,1,0.07142857142857142,13,0,466.5828261425368,5.0,0.056975228300904394
267,18,0,0.0,18,0,29953.520039591705,8.833333333333334,0.10520342434903505
268,25,0,0.0,25,0,161945.91968223365,13.04,0.08454006455639126
269,31,1,0.03225806451612903,30,0,21261.114086288057,5.67741935483871,0.07230866390529088
270,19,0,0.0,19,0,64959.81387493767,6.105263157894737,0.04468790209002537
271,25,5,0.2,20,0,30733.80178542819,4.52,0.07449343975172748
272,16,1,0.0625,15,0,53520.84132746142,6.375,0.05242093673662075
273,16,1,0.0625,15,0,7802.218837735398,5.1875,0.07414363977235719
274,13,1,0.07692307692307693,12,0,88822.36658686689,10.846153846153847,0.05452807806849669
275,30,2,0.06666666666666667,28,0,31683.15051085468,14.3,0.08429746389936901
276,36,3,0.08333333333333333,33,0,81883.29551885517,16.944444444444443,0.06797826414019284
277,11,1,0.09090909090909091,10,0,71109.32067831501,11.090909090909092,0.07050532905734908
278,14,1,0.07142857142857142,13,0,203193.37512481448,13.714285714285714,0.08468479197824319
279,11,0,0.0,11,0,4011.2727272727275,3.0,0.05464215356245554
280,12,1,0.08333333333333333,11,0,60515.2513915385,11.583333333333334,0.06343468453662625
281,13,1,0.07692307692307693,12,0,6332.59716169501,11.538461538461538,0.06357130819110343
282,15,0,0.0,15,0,59721.04449358777,11.0,0.09971106771871083
283,15,2,0.13333333333333333,13,0,3640.628878024935,9.733333333333333,0.06009334645390549
284,24,2,0.08333333333333333,22,0,47201.944501963,14.416666666666666,0.09883799316324575
285,11,1,0.09090909090909091,10,0,4441.4241554758955,6.181818181818182,0.06884522074385714
286,28,1,0.03571428571428571,27,0,135860.8202520658,9.071428571428571,0.05461432080245941
287,23,1,0.043478260869565216,22,0,168269.06874032,9.73913043478261,0.08142417576940268
288,24,0,0.0,24,0,44741.92554457217,6.708333333333333,0.079136250320458
289,13,0,0.0,13,0,0.0,11.923076923076923,0.07880944446835583
290,22,1,0.045454545454545456,21,0,38355.35870702614,8.409090909090908,0.07278011664171191
291,34,2,0.058823529411764705,32,0,39274.75961127301,7.264705882352941,0.07185348996480831
292,16,0,0.0,16,0,148950.53199217544,12.375,0.08733460311358045
293,24,0,0.0,24,0,49298.28726264394,7.958333333333333,0.06493962517977656
294,12,0,0.0,12,0,55897.23564048675,7.166666666666667,0.08498945594068275
295,16,0,0.0,16,0,17512.152906158095,13.625,0.07732553623975474
296,11,0,0.0,11,0,52519.11078492912,35.81818181818182,0.09887146987977227
297,30,1,0.03333333333333333,29,0,32465.04249633488,8.433333333333334,0.06523454880553199
298,11,0,0.0,11,0,11325.640700283373,5.545454545454546,0.06331984369952524
299,18,1,0.05555555555555555,17,0,11353.232147836537,7.777777777777778,0.06004608553165604
300,17,1,0.058823529411764705,16,0,15886.573190706371,3.176470588235294,0.03980554039201909
301,15,1,0.06666666666666667,14,0,75128.78457853686,7.2,0.06842693466238618
302,11,0,0.0,11,0,2295.1560505881284,7.0,0.07237236059304869
303,17,2,0.11764705882352941,15,0,138249.99625860402,13.529411764705882,0.045060249813687184
304,26,3,0.11538461538461539,23,0,8479.280459704732,8.076923076923077,0.05247407084640317
305,11,1,0.09090909090909091,10,0,11755.1978663605,14.909090909090908,0.10757519488891076
306,22,0,0.0,22,0,5256.557765661855,9.045454545454545,0.09997262765888001
307,13,0,0.0,13,0,295127.86801162624,15.23076923076923,0.08254206532388944
308,18,0,0.0,18,0,28138.398223891563,10.555555555555555,0.07979369440207498
309,12,0,0.0,12,0,0.0,10.333333333333334,0.07691133545334783
310,12,1,0.08333333333333333,11,0,343344.37927839026,15.333333333333334,0.09007152136015996
311,14,0,0.0,14,0,213.14223145082323,8.428571428571429,0.06860973840972892
312,20,5,0.25,15,0,30796.239868981436,4.75,0.05493491289246204
313,29,3,0.10344827586206896,26,0,6266.462729605145,8.655172413793103,0.08130611864425746
314,38,4,0.10526315789473684,34,0,196214.2919742534,12.526315789473685,0.07787195874921564
315,19,1,0.05263157894736842,18,0,63122.415163308564,9.842105263157896,0.06178929408279032
316,16,0,0.0,16,0,40694.06533719482,6.9375,0.0619382957861598
317,18,2,0.1111111111111111,16,0,35211.704773781246,9.0,0.077583451733443
318,14,1,0.07142857142857142,13,0,6907.291890499808,5.571428571428571,0.039649790899179985
319,21,2,0.09523809523809523,19,0,343571.9952785763,27.714285714285715,0.08551623108025168
320,18,1,0.05555555555555555,17,0,59882.174179535155,11.61111111111111,0.05919886212639688
321,19,2,0.10526315789473684,17,0,22930.265844194928,7.157894736842105,0.07024791939012558
322,11,2,0.18181818181818182,9,0,24134.872664076825,6.0,0.07169991460648567
323,25,1,0.04,24,0,87542.71518989706,8.6,0.07824269523383276
324,17,3,0.17647058823529413,14,0,13262.503768729523,9.882352941176471,0.09600599382074815
325,15,1,0.06666666666666667,14,0,0.0,4.466666666666667,0.06961329248108646
326,17,0,0.0,17,0,32427.788143833975,4.764705882352941,0.041908180101540994
327,15,1,0.06666666666666667,14,0,17146.444209112204,19.2,0.07804332016813255
328,40,6,0.15,34,0,19405.212647040295,8.725,0.06899127109099519
329,16,2,0.125,14,0,31253.133392444026,9.5625,0.08979534571514726
330,22,3,0.13636363636363635,19,0,1886.4449825904244,9.5,0.06427155299746225
331,19,2,0.10526315789473684,17,0,288759.08128636907,10.263157894736842,0.07455835327625883
332,13,2,0.15384615384615385,11,0,3664.522427730966,8.615384615384615,0.07935828644289131
333,15,2,0.13333333333333333,13,0,17642.8,9.133333333333333,0.07879793244841897
334,13,2,0.15384615384615385,11,0,6886.896593151248,5.230769230769231,0.10188109677797576
335,11,2,0.18181818181818182,9,0,112116.65140990139,8.909090909090908,0.07149706450150138
336,11,1,0.09090909090909091,10,0,19459.108363346586,11.909090909090908,0.08161456413776658
337,17,0,0.0,17,0,0.23529411764705882,2.4705882352941178,0.06571676510111132
338,16,3,0.1875,13,0,15978.696707458814,9.3125,0.06072528831982998
339,19,2,0.10526315789473684,17,0,15959.165361684836,8.789473684210526,0.11148695570944774
340,30,1,0.03333333333333333,29,0,58744.68894845294,17.4,0.09410488373458865
341,14,2,0.14285714285714285,12,0,10970.297040997579,12.214285714285714,0.0797662192361185
342,11,0,0.0,11,0,26037.1493530105,9.090909090909092,0.09332309709774492
343,18,0,0.0,18,0,49876.537294211514,14.277777777777779,0.08430808635370499
344,16,3,0.1875,13,0,10757.99070551509,15.25,0.08479602477407322
345,19,4,0.21052631578947367,15,0,36369.849082161185,6.631578947368421,0.0880927218192491
346,13,4,0.3076923076923077,9,0,3370.185209575862,4.3076923076923075,0.05353111373683593
347,32,1,0.03125,31,0,38799.16634742118,9.75,0.08738006592746135
348,24,3,0.125,21,0,67765.83759112885,9.458333333333334,0.07451381260254236
349,36,2,0.05555555555555555,34,0,53119.017256936204,12.472222222222221,0.06744347605375071
350,15,1,0.06666666666666667,14,0,5536.718772377181,4.933333333333334,0.08334480011187882
351,17,1,0.058823529411764705,16,0,278566.4340695817,13.882352941176471,0.06439644174023612
352,21,2,0.09523809523809523,19,0,37594.7867490906,9.333333333333334,0.07025003486887017
353,23,0,0.0,23,0,119129.50840828645,6.695652173913044,0.07544485016815189
354,19,2,0.10526315789473684,17,0,62364.55837073093,8.421052631578947,0.0731595859368427
355,18,3,0.16666666666666666,15,0,205293.6166746824,14.11111111111111,0.08190564674358122
356,18,4,0.2222222222222222,14,0,26955.555555555555,6.777777777777778,0.06239035267769583
357,15,1,0.06666666666666667,14,0,22130.18495906774,8.333333333333334,0.07746841477932416
358,17,0,0.0,17,0,132372.8894177681,10.470588235294118,0.09741135118530385
359,14,0,0.0,14,0,157639.76824733877,7.071428571428571,0.06088565744735197
360,38,4,0.10526315789473684,34,0,209059.0991049244,17.526315789473685,0.0759706053620288
361,30,1,0.03333333333333333,29,0,7654.73254608957,7.833333333333333,0.07914936033757508
362,28,2,0.07142857142857142,26,0,26383.121209295183,6.464285714285714,0.0752868766098159
363,25,2,0.08,23,0,3441.5787563972945,6.04,0.09509001363961808
364,52,4,0.07692307692307693,48,0,74540.29242423976,15.346153846153847,0.09079528436495356
365,23,2,0.08695652173913043,21,0,117567.78577087054,22.652173913043477,0.08131448977238716
366,25,3,0.12,22,0,34673.02306175988,7.68,0.06336786501755863
367,18,1,0.05555555555555555,17,0,7117.345152040758,9.666666666666666,0.06141505046043129
368,33,1,0.030303030303030304,32,0,46913.37099326351,11.787878787878787,0.06923222165039371
369,18,2,0.1111111111111111,16,0,51.80562174066305,7.5,0.07822861503699458
370,26,1,0.038461538461538464,25,0,86473.72168436916,8.5,0.08514517570989638
371,26,2,0.07692307692307693,24,0,94326.98008036325,11.76923076923077,0.08725460712227175
372,14,1,0.07142857142857142,13,0,16027.39542739905,15.785714285714286,0.09883862121778621
373,11,5,0.45454545454545453,6,0,1127.4923930418734,9.0,0.08262275415678609
374,18,2,0.1111111111111111,16,0,32624.977400062737,6.611111111111111,0.06775728533789055
375,34,4,0.11764705882352941,30,0,79683.45470029788,11.794117647058824,0.0840867096144848
376,24,0,0.0,24,0,37609.35126551246,16.666666666666668,0.07914119741893491
377,24,4,0.16666666666666666,20,0,46847.119066370266,7.791666666666667,0.0523300922908121
378,20,3,0.15,17,0,12982.461440426085,9.25,0.06608291358364934
379,25,4,0.16,21,0,15273.503275010164,7.64,0.05837044061689843
380,32,1,0.03125,31,0,154211.80736811837,10.65625,0.09772532148824195
381,16,1,0.0625,15,0,23793.136815363967,8.1875,0.05455171794812165
382,27,2,0.07407407407407407,25,0,867502.1612231061,21.14814814814815,0.09298505723035673
383,12,0,0.0,12,0,343.49162296610217,10.666666666666666,0.08499798841162727
384,16,1,0.0625,15,0,3567.547746958405,8.1875,0.08391734304898119
385,10,1,0.1,9,0,7788.907059587303,23.6,0.07437940167790334
386,18,1,0.05555555555555555,17,0,66649.68100541923,7.722222222222222,0.07662269950519536
387,21,2,0.09523809523809523,19,0,114657.21607789172,8.571428571428571,0.07428605707773914
388,12,1,0.08333333333333333,11,0,1236.547221458198,9.0,0.08288023652863118
389,30,1,0.03333333333333333,29,0,52122.338731732554,19.1,0.08887060709974495
390,12,0,0.0,12,0,20928.93984329342,11.083333333333334,0.08161955659259547
391,15,2,0.13333333333333333,13,0,8892.05240854037,6.266666666666667,0.06295224829280693
392,12,0,0.0,12,0,20728.112096542543,24.916666666666668,0.10940776005579265
393,16,1,0.0625,15,0,0.625,5.125,0.06646645709982574
394,17,1,0.058823529411764705,16,0,30649.296845473844,9.588235294117647,0.08381284972848403
395,13,1,0.07692307692307693,12,0,0.0,5.153846153846154,0.07114328717895732
396,12,0,0.0,12,0,12295.529894248752,8.083333333333334,0.07121364480671964
397,49,8,0.16326530612244897,41,0,16615.604282161723,11.73469387755102,0.07662449228292773
398,15,1,0.06666666666666667,14,0,6618.59628150999,12.866666666666667,0.06900748191130208
399,31,0,0.0,31,0,34925.11302242793,11.483870967741936,0.08869897102819703
400,21,0,0.0,21,0,6.616572941606874,10.666666666666666,0.07170480240236295
401,29,6,0.20689655172413793,23,0,66882.72021357616,10.586206896551724,0.07718443609051596
402,15,0,0.0,15,0,158.30161465006074,7.733333333333333,0.07437428844335355
403,17,2,0.11764705882352941,15,0,23627.130534550928,7.235294117647059,0.07137162092067358
404,16,0,0.0,16,0,41118.24210193053,11.8125,0.10398723020476874
405,25,2,0.08,23,0,18888.661275060294,8.8,0.0723307711232723
406,12,0,0.0,12,0,15433.311734220328,8.916666666666666,0.06057391181184738
407,44,2,0.045454545454545456,42,0,45197.30883896119,18.272727272727273,0.08728484993048723
408,20,4,0.2,16,0,54766.55754988671,10.9,0.08656475269410348
409,23,0,0.0,23,0,56647.510175751806,20.217391304347824,0.05375652897483977
410,34,5,0.14705882352941177,29,0,46135.896595651364,9.058823529411764,0.05683720792950362
411,14,2,0.14285714285714285,12,0,42088.44643037254,6.571428571428571,0.07243779872046664
412,13,2,0.15384615384615385,11,0,79119.13617783795,11.0,0.06726708893941961
413,38,3,0.07894736842105263,35,0,9647.656650221114,8.710526315789474,0.08339449639157327
414,13,0,0.0,13,0,0.061538461538461535,5.461538461538462,0.0475864207199653
415,21,0,0.0,21,0,12029.24883400161,12.857142857142858,0.09763070026524105
416,14,2,0.14285714285714285,12,0,0.0,3.0714285714285716,0.036861170328036486
417,15,0,0.0,15,0,5236.385796367913,6.2,0.054936711336988284
418,11,0,0.0,11,0,0.0,14.090909090909092,0.04322354377479702
419,51,5,0.09803921568627451,46,0,63701.47003607148,10.392156862745098,0.08003368818328166
420,23,2,0.08695652173913043,21,0,71540.3676087524,17.91304347826087,0.1016771291749855
421,20,1,0.05,19,0,97943.2838196187,5.4,0.06637391128177413
422,19,0,0.0,19,0,11088.783226704514,8.473684210526315,0.08098164086337563
423,15,1,0.06666666666666667,14,0,0.0,6.866666666666666,0.05822732689951709
424,11,1,0.09090909090909091,10,0,87383.49168130908,15.0,0.06474863910356324
425,16,0,0.0,16,0,80488.68404451528,5.3125,0.05485603425336756
426,3140,233,0.07420382165605095,2907,0,2285.3931578623997,10.91751592356688,0.08534981181019861
427,59,3,0.05084745762711865,56,0,63631.41516687129,10.0,0.07802807436448549
428,13,0,0.0,13,0,34220.832696268684,11.461538461538462,0.06875547255071844
429,13,2,0.15384615384615385,11,0,2079.3491020837796,9.846153846153847,0.0793796402542617
430,15,2,0.13333333333333333,13,0,198013.28814949546,14.2,0.07360262818871852
431,17,0,0.0,17,0,14725.200054042929,8.647058823529411,0.08011491815558308
432,16,3,0.1875,13,0,0.0,7.9375,0.06368504203636119
433,17,0,0.0,17,0,59.77566874831889,10.647058823529411,0.06090985805553273
434,24,0,0.0,24,0,75607.87025234595,7.583333333333333,0.06833107556679523
435,23,1,0.043478260869565216,22,0,2.638542257000091,7.6521739130434785,0.06800291367931387
436,31,2,0.06451612903225806,29,0,48568.888332778966,10.96774193548387,0.0635368007167505
437,20,2,0.1,18,0,228976.91799140573,20.6,0.08449692226212256
438,19,1,0.05263157894736842,18,0,53557.948247522836,11.947368421052632,0.1072135142572833
439,18,0,0.0,18,0,3724.034108582453,10.166666666666666,0.07174772383293843
440,14,1,0.07142857142857142,13,0,0.0,6.928571428571429,0.08636961267370476
441,15,2,0.13333333333333333,13,0,79886.17392233592,6.2,0.06488139473869062
442,19,1,0.05263157894736842,18,0,123859.92532880623,12.68421052631579,0.0760099549365975
443,60,6,0.1,54,0,164014.11695360442,13.366666666666667,0.079675701447215
444,14,0,0.0,14,0,30643.163622994092,8.857142857142858,0.0748409720022113
445,43,4,0.09302325581395349,39,0,209131.53162638276,12.976744186046512,0.10216819012715625
446,17,0,0.0,17,0,55086.55814938023,8.529411764705882,0.06731605358438211
447,17,3,0.17647058823529413,14,0,247232.19884780532,15.411764705882353,0.05581281143183072
448,18,2,0.1111111111111111,16,0,15515.54790607174,5.222222222222222,0.06292680881415233
449,33,2,0.06060606060606061,31,0,116711.8956696164,13.242424242424242,0.09230497363275052
450,15,2,0.13333333333333333,13,0,8797.449090605003,8.533333333333333,0.07377021027828491
451,31,1,0.03225806451612903,30,0,63908.16043362607,13.870967741935484,0.07688682078996742
452,15,1,0.06666666666666667,14,0,93230.56260382851,11.8,0.07738544744983425
453,16,1,0.0625,15,0,70402.26367961512,14.9375,0.09703307697029631
454,24,2,0.08333333333333333,22,0,13914.184664356906,9.666666666666666,0.06397955016482654
455,16,1,0.0625,15,0,11319.795945708365,14.6875,0.08324347809399851
456,14,0,0.0,14,0,8568.088286399076,8.428571428571429,0.07166843664608466
457,17,0,0.0,17,0,89238.1841912989,11.764705882352942,0.0872912059108457
458,12,0,0.0,12,0,65161.85018447282,10.916666666666666,0.07997051684852201
459,18,2,0.1111111111111111,16,0,409247.21605096885,15.0,0.06587321020192488
460,25,1,0.04,24,0,209559.83178131699,11.88,0.0820484360965964
461,31,5,0.16129032258064516,26,0,24939.366560125654,6.032258064516129,0.07569469494890724
462,12,1,0.08333333333333333,11,0,7417.456639527577,8.833333333333334,0.09692704060451125
463,26,0,0.0,26,0,106589.47165757428,10.961538461538462,0.07933503725466841
464,12,1,0.08333333333333333,11,0,45094.057423011334,23.5,0.07597612559490967
465,12,1,0.08333333333333333,11,0,30504.76912591295,6.916666666666667,0.06222536177375577
466,22,0,0.0,22,0,36796.28753729904,10.045454545454545,0.07137992064886486
467,15,0,0.0,15,0,33314.84925832082,10.533333333333333,0.0761799795318822
468,29,4,0.13793103448275862,25,0,207900.67859107905,14.10344827586207,0.07717501740398715
469,15,2,0.13333333333333333,13,0,40568.23706861334,11.666666666666666,0.08590586678883426
470,50,4,0.08,46,0,36314.10314752786,8.96,0.07169840593920436
471,17,3,0.17647058823529413,14,0,22136.38071005976,10.352941176470589,0.08746464581169373
472,18,1,0.05555555555555555,17,0,22450.949773383098,10.055555555555555,0.07196376305158175
473,22,2,0.09090909090909091,20,0,73001.28312633421,9.863636363636363,0.06777212961477198
474,14,1,0.07142857142857142,13,0,45705.56451402742,13.071428571428571,0.07145025446240215
475,18,2,0.1111111111111111,16,0,259762.19286064815,14.38888888888889,0.07030810362038827
476,28,0,0.0,28,0,140906.52590414853,12.75,0.08458975621641698
477,27,1,0.037037037037037035,26,0,57455.13892891725,11.62962962962963,0.07168848826799043
478,13,1,0.07692307692307693,12,0,49191.153846153844,7.076923076923077,0.07577443202974282
479,30,3,0.1,27,0,25461.319200146223,8.466666666666667,0.08116648192625854
480,12,0,0.0,12,0,334987.86570611136,28.25,0.060681793069020995
481,16,1,0.0625,15,0,2170.1208924335747,6.875,0.06557669272708086
482,12,1,0.08333333333333333,11,0,41786.56350593318,7.75,0.08175237225342663
483,20,1,0.05,19,0,173547.85186586503,8.7,0.06573511283042223
484,25,2,0.08,23,0,4938.336000000073,7.68,0.08095433517466423
485,25,3,0.12,22,0,26783.218187037004,7.32,0.08277160946853222
486,13,1,0.07692307692307693,12,0,58609.10394921337,9.461538461538462,0.06292080450917813
487,22,0,0.0,22,0,108706.7850339973,12.772727272727273,0.09641452055000013
488,21,4,0.19047619047619047,17,0,0.0,7.571428571428571,0.04845064309400074
489,18,1,0.05555555555555555,17,0,79997.43758141702,9.222222222222221,0.06743357201855184
490,17,1,0.058823529411764705,16,0,9125.278744010955,9.647058823529411,0.08836534803905069
491,11,1,0.09090909090909091,10,0,0.0,10.363636363636363,0.10331694603840438
492,23,1,0.043478260869565216,22,0,13865.696217730261,8.782608695652174,0.07808396416683948
493,24,6,0.25,18,0,14824.878373736245,7.25,0.07936724196802802
494,25,1,0.04,24,0,13189.110640133778,8.52,0.05625310432041502
495,15,1,0.06666666666666667,14,0,26460.0,8.666666666666666,0.0875860784815278
496,38,4,0.10526315789473684,34,0,32275.076777560895,11.605263157894736,0.0795432406132178
497,42,4,0.09523809523809523,38,0,117047.69913638502,13.857142857142858,0.09204719210766436
498,27,1,0.037037037037037035,26,0,66506.74250992617,8.555555555555555,0.06808456248242784
499,14,1,0.07142857142857142,13,0,8870.898627429735,7.571428571428571,0.07011956188018924
500,20,2,0.1,18,0,26789.819586581394,9.15,0.06356801733332887
501,34,2,0.058823529411764705,32,0,153054.2438868798,13.558823529411764,0.08549825297077028
502,15,0,0.0,15,0,74911.37994670703,16.733333333333334,0.0909873956461055
503,19,2,0.10526315789473684,17,0,154408.00411431535,9.578947368421053,0.06012900134579009
504,11,1,0.09090909090909091,10,0,0.0,4.363636363636363,0.04984683930582432
505,14,0,0.0,14,0,25731.827321895664,18.142857142857142,0.06869440891765091
506,14,1,0.07142857142857142,13,0,13283.67733723642,9.071428571428571,0.055342887417652364
507,18,0,0.0,18,0,54.03854051023396,6.277777777777778,0.058469251259197
508,15,2,0.13333333333333333,13,0,35484.419389614966,9.066666666666666,0.0885729061797025
509,13,1,0.07692307692307693,12,0,14260.078446958862,6.153846153846154,0.05731283035324703
510,29,3,0.10344827586206896,26,0,45873.62595387713,10.206896551724139,0.07141630998548959
511,20,2,0.1,18,0,274879.29468718515,19.1,0.0840734771335709
512,15,2,0.13333333333333333,13,0,6461.674808119094,7.2,0.08400988283583014
513,22,1,0.045454545454545456,21,0,24338.59084248166,9.181818181818182,0.09887603168733518
514,39,1,0.02564102564102564,38,0,62217.9429043604,8.282051282051283,0.07800930392069558
515,16,1,0.0625,15,0,60880.247969535085,5.25,0.045860306178253776
516,26,3,0.11538461538461539,23,0,14068.533500449043,7.153846153846154,0.07962908137808868
517,27,1,0.037037037037037035,26,0,6140.317641244768,10.481481481481481,0.07447093680623042
518,17,0,0.0,17,0,6472.273829215769,9.764705882352942,0.07373672633396432
519,50,4,0.08,46,0,281227.14481538616,12.72,0.08090275853223655
520,11,1,0.09090909090909091,10,0,80025.94865466251,10.454545454545455,0.08037046374356678
521,13,1,0.07692307692307693,12,0,495.82262584219853,6.153846153846154,0.06008484440938931
522,27,1,0.037037037037037035,26,0,19377.82961302556,5.62962962962963,0.08195473423344836
523,15,1,0.06666666666666667,14,0,6898.521606206335,9.6,0.07575033973642853
524,11,2,0.18181818181818182,9,0,11494.199119979328,6.545454545454546,0.05549388087375595
525,26,1,0.038461538461538464,25,0,803437.9186722878,38.0,0.0845172922307026
526,43,4,0.09302325581395349,39,0,42650.04531040573,16.953488372093023,0.09658762508954157
527,14,0,0.0,14,0,155815.30254495988,9.428571428571429,0.06050238789690888
528,28,1,0.03571428571428571,27,0,91798.3511682211,12.142857142857142,0.07931060996303209
529,20,2,0.1,18,0,105071.56441323561,10.75,0.09193316129102128
530,20,2,0.1,18,0,65821.22885414844,10.2,0.09584980263627722
531,20,2,0.1,18,0,6955.377103321732,6.4,0.055382647651788006
532,27,1,0.037037037037037035,26,0,152584.39089404626,14.703703703703704,0.09034126570390086
533,17,1,0.058823529411764705,16,0,79611.64476268076,12.058823529411764,0.08349270423174113
534,20,2,0.1,18,0,56451.24698543461,10.1,0.06732447380435783
535,11,1,0.09090909090909091,10,0,160.44413018912837,21.272727272727273,0.08402582498093858
536,22,5,0.22727272727272727,17,0,72377.87244692078,7.0,0.06215995327116675
537,17,3,0.17647058823529413,14,0,50131.38927777367,11.588235294117647,0.08387532441599045
538,26,4,0.15384615384615385,22,0,117875.70849695623,7.961538461538462,0.06364401394809721
539,12,1,0.08333333333333333,11,0,71096.37717388394,11.75,0.08554748717921545
540,29,0,0.0,29,0,26200.903762769136,17.03448275862069,0.09042893605130103
541,23,5,0.21739130434782608,18,0,26913.316072854843,10.956521739130435,0.07247001574845462
542,13,2,0.15384615384615385,11,0,7110.746837215417,7.615384615384615,0.05104448010617445
543,16,0,0.0,16,0,10355.988445235582,7.0,0.07601899759518332
544,69,6,0.08695652173913043,63,0,193392.4766195995,14.420289855072463,0.09108133430848905
545,12,0,0.0,12,0,51781.08661792654,9.916666666666666,0.05982057711135017
546,20,0,0.0,20,0,2723.527968350382,9.85,0.07563374398650052
547,30,2,0.06666666666666667,28,0,32471.068223062925,11.966666666666667,0.06961203244351223
548,40,2,0.05,38,0,16377.3320616282,11.85,0.08547112453148539
549,12,1,0.08333333333333333,11,0,24367.186262437666,11.666666666666666,0.10303412933269519
550,34,4,0.11764705882352941,30,0,46661.953716714095,8.941176470588236,0.0663270246603066
551,21,2,0.09523809523809523,19,0,6614.433215597378,8.476190476190476,0.0746650576561322
552,12,0,0.0,12,0,234160.35026129382,19.583333333333332,0.1005452541285725
553,13,2,0.15384615384615385,11,0,29377.793070483352,11.153846153846153,0.09412741254016471
554,13,1,0.07692307692307693,12,0,39252.04918343992,27.615384615384617,0.10358086106169752
555,15,2,0.13333333333333333,13,0,19776.24337569184,7.533333333333333,0.09400197442167656
556,11,2,0.18181818181818182,9,0,40580.311285144046,11.909090909090908,0.07414417789387742
557,17,0,0.0,17,0,155645.3405236003,25.705882352941178,0.08585975994523017
558,23,2,0.08695652173913043,21,0,32504.9789158903,9.565217391304348,0.08852553757955034
559,16,1,0.0625,15,0,37268.1363018754,8.75,0.08716962389461298
560,16,1,0.0625,15,0,38546.65349678617,8.3125,0.08237968406198484
561,33,2,0.06060606060606061,31,0,126117.46489766217,15.303030303030303,0.0787115617457888
562,34,1,0.029411764705882353,33,0,133536.87057407203,12.617647058823529,0.07809308023130705
563,18,2,0.1111111111111111,16,0,42366.261856583704,7.333333333333333,0.05893086616561088
564,48,3,0.0625,45,0,309697.5155722168,15.375,0.08610030929307182
565,12,1,0.08333333333333333,11,0,2220.6710807656987,7.666666666666667,0.049983286597817866
566,25,4,0.16,21,0,35170.84485164352,6.2,0.06405662157541918
567,12,2,0.16666666666666666,10,0,9633.88243257572,9.666666666666666,0.05915797260264811
568,18,2,0.1111111111111111,16,0,31703.14523353751,16.5,0.09351169965660312
569,15,2,0.13333333333333333,13,0,0.0,11.666666666666666,0.08231570744463218
570,16,0,0.0,16,0,4787.399318420393,5.25,0.06880047396455839
571,13,0,0.0,13,0,11436.076360527277,6.769230769230769,0.0695238354238249
572,27,2,0.07407407407407407,25,0,3892.839545301903,18.74074074074074,0.08591778381848313
573,17,0,0.0,17,0,88737.3732000658,12.941176470588236,0.0856901959950666
574,17,0,0.0,17,0,35197.94865258405,6.470588235294118,0.07968863327835847
575,19,1,0.05263157894736842,18,0,43889.88158879555,16.57894736842105,0.07398289293551617
576,48,1,0.020833333333333332,47,0,50549.042703162566,15.0,0.09112312500671156
577,17,1,0.058823529411764705,16,0,20634.201255834705,6.9411764705882355,0.0977588693557258
578,19,2,0.10526315789473684,17,0,9514.002184948791,9.736842105263158,0.08079983173061421
579,26,3,0.11538461538461539,23,0,11237.082092808461,9.538461538461538,0.05711977001902642
580,20,0,0.0,20,0,483746.4272291012,16.5,0.09138464367388706
581,24,1,0.041666666666666664,23,0,82575.49746902326,8.0,0.08042708569338702
582,20,1,0.05,19,0,57167.57534543426,7.65,0.06945091875420704
583,20,6,0.3,14,0,53611.72344921114,12.15,0.06993868958463946
584,19,2,0.10526315789473684,17,0,9709.401985840219,5.947368421052632,0.05180688307999999
585,11,1,0.09090909090909091,10,0,8028.363636363636,10.454545454545455,0.09143669217091772
586,12,0,0.0,12,0,15427.166518018892,14.25,0.08195847277228924
587,21,1,0.047619047619047616,20,0,196168.68974631457,16.523809523809526,0.07195459132783755
588,30,3,0.1,27,0,10999.133208398192,5.866666666666666,0.06408425766772498
589,16,4,0.25,12,0,11178.874605515091,6.375,0.08209097260598694
590,16,1,0.0625,15,0,128583.24510958866,6.9375,0.06495229963101315
591,38,2,0.05263157894736842,36,0,1997.0140507780682,8.447368421052632,0.06941661663166887
592,14,1,0.07142857142857142,13,0,514.6500325306749,6.428571428571429,0.04318386965954968
593,13,0,0.0,13,0,1246.3060330755945,10.0,0.0869265819286967
594,22,0,0.0,22,0,530327.6339872851,27.40909090909091,0.08694448914148044
595,13,0,0.0,13,0,93934.88532928316,9.384615384615385,0.08183651416776493
596,33,1,0.030303030303030304,32,0,4261.438374738128,8.303030303030303,0.09833117659615317
597,22,2,0.09090909090909091,20,0,21968.539239719157,12.0,0.0950201615885241
598,20,2,0.1,18,0,50804.99809651314,15.9,0.10453384959011391
599,17,0,0.0,17,0,11182.088955729969,6.647058823529412,0.05727471090999707
600,16,0,0.0,16,0,75043.70985850492,9.5,0.0869223650413693
601,16,1,0.0625,15,0,11248.838575322767,5.6875,0.06170498212877801
602,13,0,0.0,13,0,94573.48492657059,11.538461538461538,0.09849034749573551
603,17,0,0.0,17,0,8297.6462608414,7.470588235294118,0.05829527660027465
604,25,0,0.0,25,0,64256.965936337045,13.4,0.07963545546650742
605,24,1,0.041666666666666664,23,0,2739.1346324975216,6.791666666666667,0.05627330302675262
606,12,2,0.16666666666666666,10,0,59681.87007365142,10.5,0.09225793570756857
607,12,1,0.08333333333333333,11,0,17853.257890983354,9.333333333333334,0.07502393445796961
608,14,0,0.0,14,0,0.0,8.071428571428571,0.05885436121347234
609,13,1,0.07692307692307693,12,0,155995.92338741853,12.23076923076923,0.07277093308581516
610,17,1,0.058823529411764705,16,0,6874.225963753106,13.176470588235293,0.08775133591665375
611,14,1,0.07142857142857142,13,0,83244.05099851465,13.071428571428571,0.11490024322180765
612,30,4,0.13333333333333333,26,0,66284.2522566424,16.066666666666666,0.09161735379670417
613,44,3,0.06818181818181818,41,0,73395.6508314531,11.409090909090908,0.07986814245821902
614,11,1,0.09090909090909091,10,0,16893.600908404598,10.818181818181818,0.0563670849603051
615,16,2,0.125,14,0,10566.817983528996,11.1875,0.1049912692705117
616,15,1,0.06666666666666667,14,0,16514.693086848263,5.2,0.07732185448908074
617,16,1,0.0625,15,0,13340.932058617438,7.0,0.057499067549857355
618,11,0,0.0,11,0,16627.246698894796,10.0,0.09381079928738488
619,11,2,0.18181818181818182,9,0,43024.231309702176,10.272727272727273,0.04639906200253863
620,33,1,0.030303030303030304,32,0,369998.9303041648,18.12121212121212,0.08298040499032217
621,10,2,0.2,8,0,6922.331860924853,6.7,0.07842091385367389
622,167,8,0.04790419161676647,159,0,282296.2369556864,13.347305389221557,0.07252745749552078
623,35,2,0.05714285714285714,33,0,56603.08308020084,10.342857142857143,0.07927767669456535
624,26,2,0.07692307692307693,24,0,23919.380980185135,11.653846153846153,0.050067959054941054
625,14,2,0.14285714285714285,12,0,10929.931142896998,10.214285714285714,0.0810099797815493
626,15,0,0.0,15,0,20491.272656951,5.333333333333333,0.04999572193500509
627,19,2,0.10526315789473684,17,0,10133.119613286375,7.0,0.09004756013343723
628,19,1,0.05263157894736842,18,0,4689.81711838255,7.526315789473684,0.06652499126686295
629,24,3,0.125,21,0,3825.0376557441955,7.541666666666667,0.07879817649515165
630,15,0,0.0,15,0,0.0,5.133333333333334,0.05895001149624421
631,26,0,0.0,26,0,1264.620203055327,10.615384615384615,0.061533176855262085
632,19,1,0.05263157894736842,18,0,1301.8803022206546,9.473684210526315,0.07429772631663967
633,23,2,0.08695652173913043,21,0,27923.068483245985,7.391304347826087,0.08643978323384914
634,26,0,0.0,26,0,25451.139978770847,9.5,0.06886741421879726
635,13,0,0.0,13,0,58183.9183318156,20.846153846153847,0.09418482428644855
636,14,1,0.07142857142857142,13,0,34056.185804754954,5.714285714285714,0.06476823826853317
637,13,0,0.0,13,0,109393.88334907047,10.461538461538462,0.07135256595255693
638,11,1,0.09090909090909091,10,0,632.7471397422255,5.7272727272727275,0.060334733308808654
639,12,1,0.08333333333333333,11,0,2.738095238095236,19.583333333333332,0.05544635053676913
640,24,2,0.08333333333333333,22,0,123.96206099894816,10.208333333333334,0.07308682909878643
641,12,1,0.08333333333333333,11,0,156082.82106014798,8.583333333333334,0.08064154669206962
642,28,2,0.07142857142857142,26,0,32576.758457179407,15.607142857142858,0.07970501803722545
643,12,1,0.08333333333333333,11,0,12601.119454778074,7.0,0.0593879504721641
644,15,0,0.0,15,0,5801.351826053609,6.733333333333333,0.05279786524480728
645,23,1,0.043478260869565216,22,0,6389.9688376886925,5.086956521739131,0.08001844709235141
646,15,2,0.13333333333333333,13,0,3688.495827208035,8.666666666666666,0.07811105161713978
647,21,3,0.14285714285714285,18,0,2.7301587301587302,6.809523809523809,0.06822277485731656
648,16,0,0.0,16,0,11526.197533728957,9.3125,0.07653083911753292
649,37,6,0.16216216216216217,31,0,33236.49560363538,7.702702702702703,0.056640245942364775
650,20,1,0.05,19,0,5.154545454545445,16.9,0.07553579539057234
651,15,1,0.06666666666666667,14,0,30202.64829141641,28.066666666666666,0.1026916730025822
652,15,1,0.06666666666666667,14,0,56025.15056408897,5.8,0.05922209454847123
653,17,2,0.11764705882352941,15,0,40569.37058027304,5.9411764705882355,0.06653697876312825
654,27,2,0.07407407407407407,25,0,55548.56456593657,7.518518518518518,0.05406923018025728
655,36,4,0.1111111111111111,32,0,3070.713726000387,13.61111111111111,0.08320668359526645
656,14,1,0.07142857142857142,13,0,35651.48298372722,5.928571428571429,0.06706913316335243
657,11,0,0.0,11,0,116788.39304247581,8.909090909090908,0.07890614309394674
658,12,1,0.08333333333333333,11,0,25696.078499325293,5.416666666666667,0.0554553953467008
659,29,1,0.034482758620689655,28,0,12439.968825526888,5.137931034482759,0.06381481051758794
660,15,0,0.0,15,0,34336.54216357293,9.266666666666667,0.06622554515092482
661,26,0,0.0,26,0,106593.9023236211,9.076923076923077,0.05746011799620188
662,24,4,0.16666666666666666,20,0,74488.95967847583,10.375,0.09568339634162869
663,25,0,0.0,25,0,39599.90454049597,11.68,0.07189440475677661
664,23,5,0.21739130434782608,18,0,66814.44360316594,11.434782608695652,0.074887412108216
665,26,1,0.038461538461538464,25,0,53479.285972249105,24.615384615384617,0.09316247448373655
666,18,0,0.0,18,0,5490.040089001819,13.88888888888889,0.09850204555971692
667,28,4,0.14285714285714285,24,0,87306.57363735246,8.107142857142858,0.07473821333174233
668,21,2,0.09523809523809523,19,0,36481.81041833276,6.571428571428571,0.061143257575467645
669,14,1,0.07142857142857142,13,0,33778.279015771644,9.357142857142858,0.04746920112983214
670,19,2,0.10526315789473684,17,0,27995.770117168486,7.0,0.05712068706043228
671,17,2,0.11764705882352941,15,0,5489.421909547419,6.176470588235294,0.06821081504597622
672,22,1,0.045454545454545456,21,0,40706.42474655915,9.772727272727273,0.08267924167671621
673,26,1,0.038461538461538464,25,0,96884.27049301704,18.0,0.08943548466444448
674,15,0,0.0,15,0,29625.13200469838,10.6,0.07424577610463157
675,15,0,0.0,15,0,12190.060828633219,13.533333333333333,0.05977755003598088
676,22,2,0.09090909090909091,20,0,18991.755697825607,16.09090909090909,0.08974165054802011
677,53,5,0.09433962264150944,48,0,31331.864274693795,9.79245283018868,0.07815377020498412
678,29,3,0.10344827586206896,26,0,38971.8737373787,11.96551724137931,0.10498947717860271
679,66,5,0.07575757575757576,61,0,20489.099633845144,13.393939393939394,0.08388482668320275
680,16,2,0.125,14,0,0.0,16.0625,0.10204434981880411
681,25,3,0.12,22,0,379619.91904657736,12.44,0.098959359682069
682,24,0,0.0,24,0,79917.87222231906,12.833333333333334,0.08957584418141651
683,24,3,0.125,21,0,117660.6747273701,14.666666666666666,0.08380145979905511
684,13,1,0.07692307692307693,12,0,48045.231207090495,8.0,0.0774505358858799
685,15,1,0.06666666666666667,14,0,0.0,3.1333333333333333,0.03733303965799992
686,15,1,0.06666666666666667,14,0,72868.81280095845,11.2,0.09302611117276771
687,15,1,0.06666666666666667,14,0,118683.02374768484,18.733333333333334,0.08296011291570399
688,17,1,0.058823529411764705,16,0,208073.6126784962,13.176470588235293,0.09339996845502364
689,54,5,0.09259259259259259,49,0,113797.62241405345,17.01851851851852,0.0729688897157678
690,15,1,0.06666666666666667,14,0,8207.432024295475,11.933333333333334,0.07823089401272612
691,15,3,0.2,12,0,254508.00485152032,11.0,0.07671323567421692
692,34,1,0.029411764705882353,33,0,1140.669122994057,10.794117647058824,0.0835659338459608
693,38,3,0.07894736842105263,35,0,72624.4532471784,8.0,0.08097197046865666
694,15,0,0.0,15,0,227574.5351840215,12.933333333333334,0.07623984980608033
695,12,2,0.16666666666666666,10,0,69857.46212870644,7.083333333333333,0.08007420489937024
696,12,1,0.08333333333333333,11,0,101489.91746293101,12.416666666666666,0.07040259654974958
697,20,0,0.0,20,0,18798.057908381732,18.95,0.0881485265522362
698,11,3,0.2727272727272727,8,0,0.0,8.363636363636363,0.067364556777119
699,15,1,0.06666666666666667,14,0,39108.58328704408,9.6,0.061716041468372056
700,15,2,0.13333333333333333,13,0,10970.203065131807,13.266666666666667,0.08878165098887478
701,25,1,0.04,24,0,17610.456817969658,11.84,0.08988544467981406
702,19,1,0.05263157894736842,18,0,9458.166414723653,11.0,0.06945357569723867
703,12,1,0.08333333333333333,11,0,3676.3333333333335,30.333333333333332,0.09651325147795381
704,19,1,0.05263157894736842,18,0,107678.78785236321,11.105263157894736,0.06361612752059698
705,24,1,0.041666666666666664,23,0,67521.6939033709,19.291666666666668,0.08610351260243766
706,17,0,0.0,17,0,109921.55625153104,10.352941176470589,0.05921321545463455
707,24,3,0.125,21,0,8245.436214597148,12.166666666666666,0.08126398214340509
708,22,1,0.045454545454545456,21,0,99187.04425066836,8.681818181818182,0.08179048887925998
709,21,2,0.09523809523809523,19,0,4311.729982322773,6.857142857142857,0.06541644344247233
710,19,2,0.10526315789473684,17,0,5094.943547597114,8.578947368421053,0.08027799341381908
711,14,3,0.21428571428571427,11,0,11350.001945073669,7.642857142857143,0.09534114083596283
712,30,3,0.1,27,0,17611.10272547532,9.433333333333334,0.08175180756725751
713,37,1,0.02702702702702703,36,0,85035.77504401072,11.837837837837839,0.10493995548036894
714,31,4,0.12903225806451613,27,0,3865.844178770179,15.096774193548388,0.09613873307097616
715,18,1,0.05555555555555555,17,0,3266.8888888893907,13.5,0.07366093239129995
716,60,6,0.1,54,0,144145.088607036,13.266666666666667,0.09326397054087247
717,18,5,0.2777777777777778,13,0,5573.363931520064,7.333333333333333,0.08156846324587416
718,30,2,0.06666666666666667,28,0,112430.0924979916,17.433333333333334,0.06505180053200336
719,36,1,0.027777777777777776,35,0,48030.84626782467,9.38888888888889,0.08278816080818492
720,29,1,0.034482758620689655,28,0,16520.65645293901,9.931034482758621,0.06254775497592022
721,23,1,0.043478260869565216,22,0,31828.537822789836,8.521739130434783,0.09039274911197658
722,13,1,0.07692307692307693,12,0,40892.666508815244,10.23076923076923,0.07026776533158391
723,14,3,0.21428571428571427,11,0,16724.215174085068,12.0,0.08674815067291207
724,14,1,0.07142857142857142,13,0,0.19047619047619047,6.857142857142857,0.04689006737942592
725,29,3,0.10344827586206896,26,0,13169.691590566232,7.137931034482759,0.08186234313225206
726,20,1,0.05,19,0,56004.539569666886,10.15,0.07150241292197712
727,15,1,0.06666666666666667,14,0,46504.53147581689,11.6,0.0743587542795954
728,13,0,0.0,13,0,10005.168642839411,7.0,0.07583715150097102
729,12,0,0.0,12,0,84042.83668092113,10.416666666666666,0.08267781792018415
730,23,4,0.17391304347826086,19,0,4031.1343085012118,14.91304347826087,0.07192632341447391
731,17,1,0.058823529411764705,16,0,38312.05077153773,15.411764705882353,0.08445030218933958
732,13,0,0.0,13,0,174.01719667041294,9.384615384615385,0.06434253701077403
733,20,3,0.15,17,0,172979.19699691675,16.55,0.10608837418293485
734,18,1,0.05555555555555555,17,0,29004.23493007792,8.5,0.05105395240430306
735,21,0,0.0,21,0,83436.10507722027,14.142857142857142,0.0881861174961365
736,60,2,0.03333333333333333,58,0,18535.20070278783,9.6,0.07586298805475118
737,28,3,0.10714285714285714,25,0,31452.6661005175,8.214285714285714,0.06484889495002726
738,13,0,0.0,13,0,349.2366688814096,11.153846153846153,0.0934497012231764
739,27,0,0.0,27,0,128046.19814110704,10.481481481481481,0.07846585229554978
740,13,1,0.07692307692307693,12,0,15501.989447329648,10.461538461538462,0.07116227877716151
741,21,0,0.0,21,0,24673.66987398392,8.333333333333334,0.07323968785163319
742,16,2,0.125,14,0,0.0,7.5625,0.07464272017382756
743,21,0,0.0,21,0,111618.64031166326,13.333333333333334,0.07972772049143632
744,11,0,0.0,11,0,13197.156035881648,11.545454545454545,0.08470459564790943
745,17,2,0.11764705882352941,15,0,6306.584309061519,4.588235294117647,0.07294060514184773
746,13,0,0.0,13,0,9678.031544455203,9.461538461538462,0.09486541436376633
747,20,3,0.15,17,0,55692.78896868357,15.55,0.09558141050043975
748,30,3,0.1,27,0,5558.908217820265,5.833333333333333,0.07813182168500371
749,12,2,0.16666666666666666,10,0,46773.574618512066,9.333333333333334,0.10109561122485307
750,21,1,0.047619047619047616,20,0,70451.13876954313,11.952380952380953,0.09117769330371883
751,14,2,0.14285714285714285,12,0,9451.285714285714,9.785714285714286,0.07620699543054173
752,16,2,0.125,14,0,6403.696800436121,14.0,0.09783958498159478
753,28,5,0.17857142857142858,23,0,6912.74964896897,8.392857142857142,0.06635292738050187
754,11,1,0.09090909090909091,10,0,5869.085259643905,6.636363636363637,0.06353429315865576
755,15,1,0.06666666666666667,14,0,5882.933333333333,3.4,0.053346664457154344
756,11,1,0.09090909090909091,10,0,0.0,5.636363636363637,0.059331285742693
757,26,2,0.07692307692307693,24,0,22374.53625772635,9.653846153846153,0.09499973879547344
758,24,2,0.08333333333333333,22,0,3672.116134249775,10.166666666666666,0.06353509118277735
759,32,0,0.0,32,0,9515.641527481395,13.53125,0.07020790876528027
760,18,3,0.16666666666666666,15,0,22667.717474232275,12.0,0.08126850541979633
761,12,1,0.08333333333333333,11,0,36748.333333333336,4.5,0.056182981898577324
762,55,5,0.09090909090909091,50,0,36251.68909245203,10.8,0.06559678872026178
763,17,3,0.17647058823529413,14,0,68220.75236222504,12.764705882352942,0.07229431070018459
764,23,3,0.13043478260869565,20,0,10289.917059387739,13.26086956521739,0.0784279563243381
765,48,3,0.0625,45,0,243654.98632003934,16.541666666666668,0.0937471959859691
766,28,3,0.10714285714285714,25,0,11571.079216974264,9.464285714285714,0.07601726566801581
767,24,3,0.125,21,0,176094.5106782056,15.833333333333334,0.09926052087194503
768,11,0,0.0,11,0,5267.559700199842,5.545454545454546,0.08896629620110136
769,11,2,0.18181818181818182,9,0,0.0,8.181818181818182,0.09948593223524056
770,13,2,0.15384615384615385,11,0,127971.29728777165,11.23076923076923,0.09106747040313687
771,14,0,0.0,14,0,18962.29836428956,7.571428571428571,0.0725361902422577
772,18,2,0.1111111111111111,16,0,147831.23743174045,14.38888888888889,0.08684766201313927
773,24,2,0.08333333333333333,22,0,18271.07223320899,12.583333333333334,0.08866863314645683
774,13,1,0.07692307692307693,12,0,5.838739270959929,9.307692307692308,0.06719242617113963
775,11,0,0.0,11,0,1292.3179028557954,6.909090909090909,0.0850266312525399
776,13,1,0.07692307692307693,12,0,189312.87650805668,16.46153846153846,0.06914796865859554
777,26,4,0.15384615384615385,22,0,259212.35334775128,16.153846153846153,0.09113958585209446
778,15,2,0.13333333333333333,13,0,7360.0113790263795,7.8,0.07306621933883482
779,30,4,0.13333333333333333,26,0,59692.470563919815,14.7,0.0771012199410679
780,24,1,0.041666666666666664,23,0,12864.0,7.625,0.06139917231441148
781,13,0,0.0,13,0,5580.072427997859,10.076923076923077,0.07528153941590153
782,21,1,0.047619047619047616,20,0,51834.11756171024,8.428571428571429,0.07186408354299913
783,15,0,0.0,15,0,138379.76840077533,11.2,0.087866747757093
784,60,4,0.06666666666666667,56,0,67951.21479142227,12.383333333333333,0.07639755723917875
785,22,3,0.13636363636363635,19,0,15999.280010251194,8.545454545454545,0.08990828705643766
786,22,2,0.09090909090909091,20,0,8882.639097280893,9.5,0.05935153827116168
787,23,1,0.043478260869565216,22,0,6181.142807748494,7.304347826086956,0.0777507765027568
788,28,3,0.10714285714285714,25,0,23843.05311467595,7.178571428571429,0.08104790221316593
789,19,5,0.2631578947368421,14,0,91490.15400491591,12.210526315789474,0.09201739724336458
790,75,4,0.05333333333333334,71,0,10887.469638152299,10.88,0.07504319771218165
791,18,3,0.16666666666666666,15,0,13318.668996191465,23.5,0.07995194839307311
792,19,2,0.10526315789473684,17,0,30591.824166672734,8.842105263157896,0.07303336713884379
793,12,0,0.0,12,0,8965.909461646472,5.25,0.06650659704098723
794,11,0,0.0,11,0,81753.16039479486,10.727272727272727,0.06057344207478641
795,26,2,0.07692307692307693,24,0,12471.859317278753,7.1923076923076925,0.06584332163864846
796,17,0,0.0,17,0,39822.21978429547,13.588235294117647,0.08643189248982878
797,22,1,0.045454545454545456,21,0,84355.71670214878,23.09090909090909,0.11077937320218088
798,48,6,0.125,42,0,288199.98235495685,15.25,0.0930989548407863
799,15,1,0.06666666666666667,14,0,192512.45888574977,20.933333333333334,0.09201722383735282
800,13,0,0.0,13,0,23488.569031132538,8.076923076923077,0.05619709203325372
801,31,4,0.12903225806451613,27,0,11300.6289582541,15.0,0.09894778607344248
802,24,1,0.041666666666666664,23,0,13321.02634758772,12.75,0.10113946309796062
803,11,1,0.09090909090909091,10,0,4659.888698858423,6.545454545454546,0.05678844677779901
804,23,6,0.2608695652173913,17,0,12260.70747487147,11.26086956521739,0.071422396406476
805,35,4,0.11428571428571428,31,0,82267.48930330627,11.114285714285714,0.09285183940678256
806,12,1,0.08333333333333333,11,0,0.0,9.916666666666666,0.07596131203966842
807,11,0,0.0,11,0,11471.026920212702,5.0,0.049625065800299684
808,36,5,0.1388888888888889,31,0,58734.677954006445,16.194444444444443,0.07697894992450834
809,14,1,0.07142857142857142,13,0,45630.7273907856,11.285714285714286,0.09118012397935196
810,11,3,0.2727272727272727,8,0,18942.446885969028,12.909090909090908,0.06218683468547743
811,32,4,0.125,28,0,106437.19626952341,9.53125,0.09262227123249994
812,14,0,0.0,14,0,523.2420134201351,6.5,0.059315793280223884
813,31,2,0.06451612903225806,29,0,7311.835945854936,12.193548387096774,0.08783890364953116
814,29,4,0.13793103448275862,25,0,3701.485924357726,13.793103448275861,0.07060325728725361
815,27,1,0.037037037037037035,26,0,29595.663905068108,17.666666666666668,0.10094733294897333
816,22,0,0.0,22,0,33901.883750319255,9.909090909090908,0.06785389846559327
817,19,1,0.05263157894736842,18,0,31716.583590758877,7.105263157894737,0.07193975501913882
818,20,1,0.05,19,0,89932.956553773,7.5,0.07740407759300269
819,11,0,0.0,11,0,5736.9841351729765,14.090909090909092,0.11295686690984978
820,29,3,0.10344827586206896,26,0,625.4045555061879,10.482758620689655,0.074213798643943
821,28,1,0.03571428571428571,27,0,29922.26057982212,6.678571428571429,0.06183801384081644
822,15,1,0.06666666666666667,14,0,96.80223947892877,22.666666666666668,0.11371633870199839
823,21,2,0.09523809523809523,19,0,97670.87981952626,11.952380952380953,0.06375050262881478
824,12,3,0.25,9,0,13477.7777777726,9.166666666666666,0.09458143176102747
825,11,2,0.18181818181818182,9,0,3638.662165109473,8.545454545454545,0.05134034524111109
826,36,4,0.1111111111111111,32,0,37093.09987290304,8.88888888888889,0.07100141972552343
827,12,1,0.08333333333333333,11,0,24591.476210430857,8.083333333333334,0.056976520813039166
828,28,1,0.03571428571428571,27,0,56187.67729131052,8.75,0.08959346609991327
829,11,0,0.0,11,0,4014.3636363636365,6.545454545454546,0.07975468974036913
830,17,0,0.0,17,0,57146.99295398674,11.647058823529411,0.07157269786718284
831,35,3,0.08571428571428572,32,0,1434.7498683455965,11.428571428571429,0.08407890325816174
832,30,1,0.03333333333333333,29,0,64022.10061961672,13.966666666666667,0.08980873703652653
833,30,1,0.03333333333333333,29,0,57.47142355599704,7.333333333333333,0.05569993265992535
834,24,2,0.08333333333333333,22,0,28016.390532157646,11.625,0.09623645612660174
835,15,0,0.0,15,0,14203.864851165261,11.533333333333333,0.09335636550997027
836,12,3,0.25,9,0,3.694748963138771,7.25,0.06460784772751811
837,17,0,0.0,17,0,4.0355416229759005,7.470588235294118,0.05967300835723426
838,19,0,0.0,19,0,11717.216546627349,9.578947368421053,0.05929077106377713
839,41,6,0.14634146341463414,35,0,75851.9161543926,12.317073170731707,0.09005302966651119
840,37,2,0.05405405405405406,35,0,53203.85610473886,8.45945945945946,0.08264391828858847
841,21,1,0.047619047619047616,20,0,15134.20343164553,9.904761904761905,0.08755283108200067
842,22,2,0.09090909090909091,20,0,38355.14820849233,14.409090909090908,0.07684673845388335
843,19,0,0.0,19,0,192148.70514570922,11.894736842105264,0.08103943180123473
844,20,1,0.05,19,0,95448.00093296292,9.85,0.08681147913944562
845,26,1,0.038461538461538464,25,0,71610.25549983613,6.846153846153846,0.09145488499799814
846,12,1,0.08333333333333333,11,0,15655.571755342879,17.416666666666668,0.11648502766603908
847,17,1,0.058823529411764705,16,0,8627.3455724921,6.411764705882353,0.04957979091320192
848,15,2,0.13333333333333333,13,0,13576.051756332574,10.4,0.10355548954327845
849,16,1,0.0625,15,0,8102.39701501996,9.6875,0.07643079027453004
850,10,3,0.3,7,0,0.0,8.2,0.05034608424671463
851,15,1,0.06666666666666667,14,0,247238.7235014775,8.066666666666666,0.053383742635085184
852,13,3,0.23076923076923078,10,0,0.0,7.538461538461538,0.04806675798589898
853,31,0,0.0,31,0,166492.55380266812,13.193548387096774,0.07245136661298973
854,11,0,0.0,11,0,71130.04307097738,15.818181818181818,0.09491942534861847
855,11,0,0.0,11,0,215.80699061716086,6.090909090909091,0.059448176059192726
856,14,3,0.21428571428571427,11,0,15681.257045630939,19.785714285714285,0.08595012302792275
857,11,1,0.09090909090909091,10,0,8411.897655516463,6.909090909090909,0.052377004419746326
858,20,0,0.0,20,0,10833.57400638483,10.65,0.10524081186739306
859,21,0,0.0,21,0,34418.590133421836,11.619047619047619,0.09957109511748354
860,21,2,0.09523809523809523,19,0,3775.636430865909,8.666666666666666,0.08692537218493877
861,16,1,0.0625,15,0,0.0,10.5,0.09160175406743237
862,13,2,0.15384615384615385,11,0,17191.556993776423,10.76923076923077,0.07969000828836736
863,11,0,0.0,11,0,47158.65672135344,12.545454545454545,0.08330077639244547
864,28,2,0.07142857142857142,26,0,2369.949014025566,7.642857142857143,0.07057679788689569
865,22,4,0.18181818181818182,18,0,17248.654769419136,9.863636363636363,0.08017076288206636
866,25,1,0.04,24,0,50185.45234668764,8.2,0.06593989234405466
867,19,4,0.21052631578947367,15,0,74686.93412555719,10.526315789473685,0.0735709981818503
868,12,0,0.0,12,0,0.16666666666666666,9.25,0.09956553360612423
869,12,1,0.08333333333333333,11,0,98007.34668221751,5.5,0.069802791370688
870,11,0,0.0,11,0,14011.307672309433,10.454545454545455,0.07913440744368148
871,15,1,0.06666666666666667,14,0,59229.65497251789,15.133333333333333,0.07647627327754122
872,10,0,0.0,10,0,0.0,8.1,0.03785986777603192
873,11,1,0.09090909090909091,10,0,0.21818181818181817,9.545454545454545,0.07363783531461626
874,31,0,0.0,31,0,6493.655929983277,14.096774193548388,0.08619503107786067
875,19,0,0.0,19,0,22766.43340799732,8.631578947368421,0.07712942327879757
876,18,1,0.05555555555555555,17,0,16094.15666006698,16.333333333333332,0.10769974107844939
877,18,1,0.05555555555555555,17,0,26816.91380889922,10.88888888888889,0.08260843624459728
878,15,2,0.13333333333333333,13,0,17319.583015013042,6.666666666666667,0.06153829973545712
879,27,3,0.1111111111111111,24,0,91506.89441591968,10.814814814814815,0.0809595941635221
880,19,0,0.0,19,0,221940.1198970323,15.68421052631579,0.08821580848746544
881,34,4,0.11764705882352941,30,0,57638.15538709832,13.617647058823529,0.07728077784866395
882,28,4,0.14285714285714285,24,0,28547.613260971968,11.535714285714286,0.07942793120140001
883,15,1,0.06666666666666667,14,0,134662.40210225974,9.533333333333333,0.06615446815332403
884,21,0,0.0,21,0,12045.650884834151,12.476190476190476,0.06980197546457967
885,20,0,0.0,20,0,14817.881476736296,12.05,0.08775541780519111
886,12,1,0.08333333333333333,11,0,36752.93463687696,5.916666666666667,0.07086701498527027
887,13,0,0.0,13,0,176896.19642865172,15.307692307692308,0.07710993718652136
888,26,2,0.07692307692307693,24,0,71886.9282920625,13.76923076923077,0.07397323071847527
889,19,2,0.10526315789473684,17,0,23484.156005706674,13.736842105263158,0.09428864265839629
890,15,1,0.06666666666666667,14,0,45176.180313040844,11.533333333333333,0.08175824868064811
891,11,1,0.09090909090909091,10,0,5179.356259875076,13.181818181818182,0.11990141248534111
892,15,3,0.2,12,0,915.9439494337754,9.6,0.05871242325312265
893,22,1,0.045454545454545456,21,0,22873.1121725974,8.272727272727273,0.06963265119434604
894,27,3,0.1111111111111111,24,0,4932.274495080629,11.777777777777779,0.08736671230294925
895,14,1,0.07142857142857142,13,0,2261.7682200273935,16.0,0.11010254836909734
896,13,1,0.07692307692307693,12,0,26935.266435020367,10.153846153846153,0.07909303718042601
897,27,3,0.1111111111111111,24,0,4076.5037541249444,4.925925925925926,0.06460723360344209
898,20,1,0.05,19,0,17541.237795026704,7.7,0.055238486670925305
899,25,3,0.12,22,0,48374.922359235694,10.28,0.06100388284055668
900,13,1,0.07692307692307693,12,0,0.0,7.6923076923076925,0.044659197146425494
901,37,2,0.05405405405405406,35,0,46956.68574237891,10.054054054054054,0.07416780518694463
902,24,1,0.041666666666666664,23,0,163402.21334932934,20.958333333333332,0.06905476463383309
903,15,0,0.0,15,0,47320.96253119607,14.866666666666667,0.07394388764373686
904,13,2,0.15384615384615385,11,0,7877.665421427324,4.230769230769231,0.061422862783084356
905,36,2,0.05555555555555555,34,0,20438.214177171492,8.583333333333334,0.08362314287803779
906,14,2,0.14285714285714285,12,0,298406.56388585543,17.214285714285715,0.093843125291897
907,13,2,0.15384615384615385,11,0,47991.52458699893,9.0,0.08986357260971879
908,26,4,0.15384615384615385,22,0,599871.2643126483,14.461538461538462,0.07092621238553307
909,31,5,0.16129032258064516,26,0,222101.74544871075,15.387096774193548,0.0735752030805473
910,14,0,0.0,14,0,10780.806635882627,19.357142857142858,0.08004177584206959
911,15,2,0.13333333333333333,13,0,405932.35685621615,25.066666666666666,0.1045790512350635
912,12,1,0.08333333333333333,11,0,3676.3333333333335,8.166666666666666,0.059299970839503724
913,17,0,0.0,17,0,29392.592705666626,9.705882352941176,0.06572918269325559
914,23,0,0.0,23,0,30869.09068719377,12.695652173913043,0.08988629119192094
915,27,3,0.1111111111111111,24,0,24400.801194599604,4.814814814814815,0.06471839174162788
916,13,2,0.15384615384615385,11,0,0.0,8.615384615384615,0.06038391991108079
917,24,1,0.041666666666666664,23,0,52966.45850271444,12.041666666666666,0.07803684611289968
918,34,6,0.17647058823529413,28,0,31691.100700972507,13.5,0.07811038418077335
919,19,2,0.10526315789473684,17,0,20998.37768173373,12.105263157894736,0.0581789483959627
920,14,1,0.07142857142857142,13,0,114370.95324574465,11.714285714285714,0.08344373838476114
921,20,4,0.2,16,0,0.0,6.25,0.04924652732609898
922,19,2,0.10526315789473684,17,0,29326.252830360165,13.578947368421053,0.09811125052624153
923,16,0,0.0,16,0,25358.896967300174,7.375,0.06809047523102492
924,22,2,0.09090909090909091,20,0,52543.104532947975,11.681818181818182,0.08186143695475191
925,23,3,0.13043478260869565,20,0,14948.925070744766,14.434782608695652,0.06943040382373361
926,16,3,0.1875,13,0,46493.91372147013,10.3125,0.07942837860276822
927,23,0,0.0,23,0,64028.573363374424,10.173913043478262,0.08475079284985668
928,29,2,0.06896551724137931,27,0,26393.02018463945,9.206896551724139,0.06093710528757179
929,27,1,0.037037037037037035,26,0,25473.359505465378,12.925925925925926,0.09199901755133061
930,44,3,0.06818181818181818,41,0,40016.19880823971,17.318181818181817,0.06916208335685196
931,12,0,0.0,12,0,161684.17488111087,12.666666666666666,0.08317272641987519
932,17,5,0.29411764705882354,12,0,348.60388074297555,13.529411764705882,0.06507185093679606
933,19,3,0.15789473684210525,16,0,23779.725630921956,6.947368421052632,0.08998644752864973
934,46,8,0.17391304347826086,38,0,73162.50661906558,10.434782608695652,0.06764289783433221
935,19,1,0.05263157894736842,18,0,9636.423034965961,17.0,0.07840615651611203
936,12,0,0.0,12,0,7494.381541350153,9.833333333333334,0.06353606122009586
937,17,0,0.0,17,0,8247.000781765977,9.176470588235293,0.06363276626029281
938,44,6,0.13636363636363635,38,0,646850.4552451427,14.204545454545455,0.08104799594344193
939,18,0,0.0,18,0,109591.99404838258,8.555555555555555,0.06750507741535396
940,12,0,0.0,12,0,0.0,7.833333333333333,0.06848218771639794
941,13,0,0.0,13,0,73950.95343499185,8.692307692307692,0.0748054098777413
942,18,0,0.0,18,0,25113.907215045452,6.444444444444445,0.07106627751898806
943,13,1,0.07692307692307693,12,0,37899.74971688694,7.230769230769231,0.06696962603982813
944,13,2,0.15384615384615385,11,0,17793.59472293815,17.846153846153847,0.1000417492672651
945,13,2,0.15384615384615385,11,0,104876.84250996611,13.923076923076923,0.09058072022538662
946,14,2,0.14285714285714285,12,0,1462.8445206174706,6.857142857142857,0.06749703433456257
947,17,0,0.0,17,0,104261.81951817879,8.705882352941176,0.08330156022996064
948,13,1,0.07692307692307693,12,0,6109.370227166522,8.384615384615385,0.06273761357148566
949,20,2,0.1,18,0,63208.09081500668,6.95,0.08209052086210293
950,38,2,0.05263157894736842,36,0,37386.561881869544,11.447368421052632,0.08515110005915075
951,28,6,0.21428571428571427,22,0,40352.3395399843,9.821428571428571,0.08321413794186185
952,16,0,0.0,16,0,143614.88041088395,15.9375,0.08910848140727223
953,30,1,0.03333333333333333,29,0,985.4904166667469,9.266666666666667,0.06309967409264468
954,15,1,0.06666666666666667,14,0,40016.876122842295,14.933333333333334,0.10166897594655105
955,20,0,0.0,20,0,0.0,9.2,0.07526253500635487
956,22,2,0.09090909090909091,20,0,41147.5054635904,13.772727272727273,0.07717242815568835
957,12,2,0.16666666666666666,10,0,61232.9393721352,17.75,0.07188375941105457
958,16,1,0.0625,15,0,74323.63123884077,11.4375,0.07853870690478626
959,27,3,0.1111111111111111,24,0,15806.46166278392,8.185185185185185,0.06993375167574264
960,22,0,0.0,22,0,3861.0111318596246,14.181818181818182,0.0932904789207361
961,15,3,0.2,12,0,88082.92907411892,12.133333333333333,0.08422922515361073
962,14,1,0.07142857142857142,13,0,147834.99999999997,8.428571428571429,0.0815760718117758
963,16,3,0.1875,13,0,71797.73280090677,13.25,0.08411750666589912
964,20,0,0.0,20,0,49430.269546600415,13.9,0.10800673743906275
965,13,3,0.23076923076923078,10,0,4863.910792528651,4.538461538461538,0.0561154888634362
966,19,0,0.0,19,0,77217.25030902892,10.157894736842104,0.09843986966124492
967,23,0,0.0,23,0,1938870.4669336684,34.26086956521739,0.08681010650019708
968,21,1,0.047619047619047616,20,0,9056.655376716883,6.428571428571429,0.06754026050874214
969,35,0,0.0,35,0,581043.4268023364,22.02857142857143,0.10088238120765489
970,11,1,0.09090909090909091,10,0,71353.53860855,23.363636363636363,0.12117155990365101
971,25,2,0.08,23,0,116247.34249598245,12.56,0.06334468676476356
972,29,1,0.034482758620689655,28,0,100074.82714182339,16.03448275862069,0.0852279756383827
973,15,2,0.13333333333333333,13,0,50121.56243500945,10.2,0.10782264011269446
974,19,0,0.0,19,0,12783.112515079318,8.947368421052632,0.07587257115576329
975,20,1,0.05,19,0,81.44634536294703,12.15,0.0917076251880375
976,25,2,0.08,23,0,19712.370607072156,13.4,0.08244868069675522
977,16,1,0.0625,15,0,464493.4078168024,20.75,0.10020262285978926
978,36,3,0.08333333333333333,33,0,260221.91851245446,11.944444444444445,0.08928537205941367
979,12,1,0.08333333333333333,11,0,12394.458140347802,17.666666666666668,0.09255025234155484
980,11,0,0.0,11,0,21908.243687523467,22.90909090909091,0.09161174338948606
981,26,2,0.07692307692307693,24,0,48374.64051159176,11.076923076923077,0.09487529504500371
982,15,1,0.06666666666666667,14,0,123756.59565734104,9.866666666666667,0.07504089683365306
983,16,1,0.0625,15,0,17508.595247563357,9.75,0.05489203702128876
984,11,0,0.0,11,0,6181.589111200811,8.454545454545455,0.04322841335896774
985,12,2,0.16666666666666666,10,0,0.0,2.4166666666666665,0.09377378122926372
986,14,4,0.2857142857142857,10,0,3.8283060398950783,5.785714285714286,0.0735823680878284
987,11,3,0.2727272727272727,8,0,5913.267973109342,8.636363636363637,0.052507971547036146
988,16,0,0.0,16,0,21413.636112038464,10.1875,0.06364418380082647
989,11,1,0.09090909090909091,10,0,926.9154692913107,6.181818181818182,0.09109962682920504
990,14,1,0.07142857142857142,13,0,570459.2147984396,10.214285714285714,0.09010063814379074
991,12,3,0.25,9,0,36413.02417172689,6.333333333333333,0.0423045339412288
992,13,1,0.07692307692307693,12,0,0.3076923076923077,6.076923076923077,0.03588025667125027
993,11,1,0.09090909090909091,10,0,13189.538201782707,6.909090909090909,0.06712126153808534
994,18,3,0.16666666666666666,15,0,75791.63048414713,9.5,0.077901561524009
995,12,2,0.16666666666666666,10,0,19600.16666666433,6.333333333333333,0.047001674245107115
996,14,0,0.0,14,0,0.0,7.0,0.09152089749717432
997,14,0,0.0,14,0,8125.668093540085,10.428571428571429,0.05414182803574026
998,12,0,0.0,12,0,63273.238075342444,8.75,0.09111080033702641
999,12,1,0.08333333333333333,11,0,11103.940451822042,5.75,0.06293503755896321
1000,11,1,0.09090909090909091,10,0,135671.57364217524,10.818181818181818,0.061882423014329974
1001,13,3,0.23076923076923078,10,0,46074.783210255744,8.923076923076923,0.08011647493561104
1002,46,6,0.13043478260869565,40,0,48022.287039975374,9.5,0.07089670603832579
1003,31,1,0.03225806451612903,30,0,22429.51526528677,5.612903225806452,0.07519911857378367
1004,19,4,0.21052631578947367,15,0,51456.900911923185,7.631578947368421,0.08026697861881302
1005,99,8,0.08080808080808081,91,0,27832.957636503517,8.090909090909092,0.07388758611781454
1006,15,1,0.06666666666666667,14,0,96403.2754861294,14.533333333333333,0.07534912336939868
1007,114,10,0.08771929824561403,104,0,29250.54996141271,7.842105263157895,0.06473713179800328
1008,13,1,0.07692307692307693,12,0,500.6449229495566,6.384615384615385,0.0885669672450246
1009,35,4,0.11428571428571428,31,0,19040.227959197648,7.4,0.07658250299738628
1010,13,0,0.0,13,0,139014.70330409563,10.153846153846153,0.062186141330322395
1011,22,1,0.045454545454545456,21,0,107327.99367990311,11.409090909090908,0.081164946225766
1012,12,1,0.08333333333333333,11,0,8684.890990237496,8.333333333333334,0.08264049410005435
1013,19,1,0.05263157894736842,18,0,41906.110333004544,11.421052631578947,0.10021611339594338
1014,19,1,0.05263157894736842,18,0,160708.07463032342,22.736842105263158,0.1064167616548209
1015,13,1,0.07692307692307693,12,0,188498.24878893554,14.538461538461538,0.09855776198704601
1016,11,1,0.09090909090909091,10,0,0.0,3.1818181818181817,0.04977245028772782
1017,33,5,0.15151515151515152,28,0,27224.93012853095,12.727272727272727,0.06637329705658877
1018,87,10,0.11494252873563218,77,0,70583.87472035839,10.057471264367816,0.07906352307872468
1019,74,6,0.08108108108108109,68,0,15750.786874111622,7.22972972972973,0.08030360131529246
1020,131,13,0.09923664122137404,118,0,32217.231374162675,8.580152671755725,0.07018199443647677
1021,887,77,0.08680947012401354,810,0,51710.75917869942,9.271702367531004,0.0721993527117279
1022,12,1,0.08333333333333333,11,0,28456.83664805982,7.666666666666667,0.05039066492345925
1023,35,1,0.02857142857142857,34,0,58013.585991530315,10.428571428571429,0.055984532065922445
1024,11,0,0.0,11,0,11369.547239481311,14.636363636363637,0.06309749154061528
1025,12,3,0.25,9,0,17443.151954668545,7.666666666666667,0.040073436322011984
1026,933,69,0.07395498392282958,864,0,46212.45230885409,9.27331189710611,0.0715807191897519
1027,13,0,0.0,13,0,167219.99028087017,11.846153846153847,0.09103998367516135
1028,12,1,0.08333333333333333,11,0,12498.512553936722,7.666666666666667,0.07458536165698419
1029,11,3,0.2727272727272727,8,0,0.0,6.818181818181818,0.07000102143718312
1030,2303,188,0.08163265306122448,2115,0,54171.486720061366,9.639600521059487,0.07543745394059492
