,total,LMICs,LMICs_perc,HICs,Unknown,Avg BC,Avg DC,Avg CC
0,5040,263,0.052182539682539685,4777,0,113190.20355073821,67.07281746031747,0.11146418594099002
1,27,1,0.037037037037037035,26,0,58237.55065523906,17.555555555555557,0.09145296007393001
2,19,0,0.0,19,0,13251.346683827336,37.8421052631579,0.11181833915992685
3,50,4,0.08,46,0,214010.65306604933,20.98,0.12629425595253257
4,25,0,0.0,25,0,21226.367074212845,18.08,0.09422767484247432
5,34,3,0.08823529411764706,31,0,71693.26106225146,19.852941176470587,0.10249783877032129
6,43,3,0.06976744186046512,40,0,33436.87730728262,16.093023255813954,0.09258181045329898
7,29,2,0.06896551724137931,27,0,936.9716880074197,16.896551724137932,0.07889338805353971
8,35,2,0.05714285714285714,33,0,148941.7617142715,204.28571428571428,0.11354786100810421
9,42,3,0.07142857142857142,39,0,258647.1994880605,18.904761904761905,0.09808114680107785
10,30,1,0.03333333333333333,29,0,67480.45599356547,21.366666666666667,0.11596231455785352
11,41,2,0.04878048780487805,39,0,47148.75532151944,14.804878048780488,0.09461451630890078
12,15,1,0.06666666666666667,14,0,56944.676612008014,21.2,0.10623465078867503
13,22,2,0.09090909090909091,20,0,123097.71347179894,23.681818181818183,0.08261795550217789
14,33,1,0.030303030303030304,32,0,76059.72495677197,40.54545454545455,0.07853985346003006
15,31,3,0.0967741935483871,28,0,17687.94439998854,26.580645161290324,0.09999833811886012
16,25,0,0.0,25,0,267819.90008000506,59.2,0.09485025181642653
17,14,0,0.0,14,0,1514.2012287611585,83.42857142857143,0.10457523544192322
18,40,2,0.05,38,0,350988.63432915055,20.225,0.0959272569960934
19,19,1,0.05263157894736842,18,0,456.80797473107333,24.42105263157895,0.11235605394980212
20,11,0,0.0,11,0,0.0,34.63636363636363,0.11406822236265354
21,23,1,0.043478260869565216,22,0,8684.379829934365,16.0,0.09705529342885744
22,11,1,0.09090909090909091,10,0,27040.886831434444,634.8181818181819,0.14480200021927128
23,40,3,0.075,37,0,163451.20123232907,50.875,0.09665914207028965
24,128,3,0.0234375,125,0,129419.99187851786,23.2109375,0.09411760639365996
25,15,0,0.0,15,0,39521.08894658966,16.6,0.1382056301879146
26,15,1,0.06666666666666667,14,0,512217.04968317586,37.13333333333333,0.13789446414009257
27,38,1,0.02631578947368421,37,0,1495.2557439248887,580.0263157894736,0.15014921014095264
28,14,2,0.14285714285714285,12,0,0.0,16.285714285714285,0.10759221934461789
29,23,1,0.043478260869565216,22,0,270890.01853411103,34.04347826086956,0.11656533386504642
30,30,0,0.0,30,0,78580.83991623431,12.533333333333333,0.12337194782956924
31,23,1,0.043478260869565216,22,0,58549.69199101285,25.130434782608695,0.10375777085354816
32,11,0,0.0,11,0,87605.37352936815,118.18181818181819,0.14673276297257984
33,24,0,0.0,24,0,156888.0280654682,30.041666666666668,0.10653292349742473
34,25,2,0.08,23,0,542.4495776807104,22.76,0.1389755670517924
35,40,2,0.05,38,0,59489.891054554006,24.475,0.10033437634443176
36,41,3,0.07317073170731707,38,0,804548.8281742992,27.75609756097561,0.10978672240245066
37,15,1,0.06666666666666667,14,0,59589.296590339865,32.93333333333333,0.10479500481294436
38,13,0,0.0,13,0,8568.878869394635,12.307692307692308,0.08931559779493939
39,21,2,0.09523809523809523,19,0,6410.115790764923,19.904761904761905,0.09760231061724103
40,21,1,0.047619047619047616,20,0,170652.22125948264,17.761904761904763,0.10080777268949619
41,12,0,0.0,12,0,12536.249999999995,15.0,0.09654741961569012
42,22,0,0.0,22,0,11920.939576700119,17.545454545454547,0.086580931366832
43,34,2,0.058823529411764705,32,0,487074.54121654405,43.64705882352941,0.09506700780896794
44,17,1,0.058823529411764705,16,0,107087.43751230229,30.88235294117647,0.09152801342834581
45,13,1,0.07692307692307693,12,0,0.0,28.076923076923077,0.11210092595093274
46,34,3,0.08823529411764706,31,0,107423.39091549785,15.588235294117647,0.10233758069431322
47,18,3,0.16666666666666666,15,0,5113.78379192395,13.666666666666666,0.11950964572045963
48,15,3,0.2,12,0,85186.65269094646,16.133333333333333,0.10500734867082244
49,14,0,0.0,14,0,994050.5424443464,96.5,0.11013991631264565
50,14,0,0.0,14,0,96177.20999348974,30.142857142857142,0.09149967449434793
51,25,2,0.08,23,0,1276.7639929281502,635.6,0.1532222814018283
52,24,3,0.125,21,0,5785.197615280177,27.458333333333332,0.09304541376461772
53,24,1,0.041666666666666664,23,0,98300.3273924216,35.708333333333336,0.1127874018002361
54,21,0,0.0,21,0,12361.985490472342,8.238095238095237,0.10314439723447438
55,22,0,0.0,22,0,116394.67674765359,18.545454545454547,0.12064001223002041
56,26,1,0.038461538461538464,25,0,151352.82443940116,15.23076923076923,0.13125654030917666
57,15,0,0.0,15,0,0.0,9.4,0.10568963191204284
58,13,0,0.0,13,0,22838.538775408066,25.0,0.09390430877960483
59,47,2,0.0425531914893617,45,0,80359.68494276992,51.4468085106383,0.10179006093433836
60,27,3,0.1111111111111111,24,0,53486.9305919415,22.666666666666668,0.10607664228676461
61,21,1,0.047619047619047616,20,0,74069.33384503971,26.19047619047619,0.0997793092591165
62,11,1,0.09090909090909091,10,0,1509.3630670888,10.545454545454545,0.09059392582292634
63,19,0,0.0,19,0,69817.91217829478,11.210526315789474,0.08835859684508
64,15,3,0.2,12,0,0.0,16.266666666666666,0.12608424275424174
65,47,3,0.06382978723404255,44,0,237052.59019804397,18.27659574468085,0.1113026906628156
66,18,2,0.1111111111111111,16,0,5.6287411104186775,19.11111111111111,0.10054746648612553
67,52,1,0.019230769230769232,51,0,15356.751575881879,13.538461538461538,0.09830185716283511
68,39,0,0.0,39,0,148905.59817122965,46.76923076923077,0.1271918692418025
69,21,0,0.0,21,0,37678.450933979744,40.714285714285715,0.1191756007584564
70,13,1,0.07692307692307693,12,0,0.01809954751131222,19.307692307692307,0.11740764147672361
71,12,0,0.0,12,0,0.0,33.75,0.12444212416314437
72,11,1,0.09090909090909091,10,0,0.0,4.545454545454546,0.08328973718066678
73,13,0,0.0,13,0,33947.23487219149,15.461538461538462,0.09041218438114154
74,25,2,0.08,23,0,78963.31904781215,13.68,0.11816048616458906
75,23,1,0.043478260869565216,22,0,24596.76884497535,25.91304347826087,0.09540053982164526
76,13,0,0.0,13,0,0.0,11.153846153846153,0.08711678625823466
77,22,0,0.0,22,0,1367.9845154845118,9.090909090909092,0.09579892050608318
78,29,0,0.0,29,0,130766.0270021714,14.206896551724139,0.10971487202064235
79,20,2,0.1,18,0,54952.04540721771,16.2,0.10760084552351415
80,44,3,0.06818181818181818,41,0,94678.75104514102,72.11363636363636,0.11206243058858378
81,24,1,0.041666666666666664,23,0,52718.93032475311,12.333333333333334,0.11568377977995958
82,21,1,0.047619047619047616,20,0,283034.6720636262,182.1904761904762,0.15189211959073307
83,37,2,0.05405405405405406,35,0,1969.0543348650838,28.756756756756758,0.10815010843816215
84,20,0,0.0,20,0,95917.85742442904,15.95,0.11533726408104272
85,25,3,0.12,22,0,73746.10996876653,12.56,0.11727409847170149
86,113,6,0.05309734513274336,107,0,228238.28476874263,22.98230088495575,0.10747290594786443
87,25,1,0.04,24,0,6258.599199010059,112.56,0.09378305587414873
88,28,3,0.10714285714285714,25,0,76269.68774413259,17.107142857142858,0.11811875777507229
89,30,3,0.1,27,0,76205.32348641934,24.3,0.1192616697684674
90,33,0,0.0,33,0,166028.90363814431,14.06060606060606,0.09640202038617242
91,13,1,0.07692307692307693,12,0,155.68496190689928,95.61538461538461,0.09975782453173596
92,33,4,0.12121212121212122,29,0,37138.442146017485,23.818181818181817,0.11123276156645331
93,29,1,0.034482758620689655,28,0,3054.8703258495284,12.10344827586207,0.10470197054158954
94,22,2,0.09090909090909091,20,0,165605.1830617799,23.09090909090909,0.07542692491973944
95,25,4,0.16,21,0,467590.8889886175,16.56,0.09444462052039926
96,27,4,0.14814814814814814,23,0,61481.559167583335,16.925925925925927,0.12177744995980472
97,31,3,0.0967741935483871,28,0,53958.488689320075,14.709677419354838,0.09306342603788514
98,19,1,0.05263157894736842,18,0,43971.90907207767,13.894736842105264,0.10095937169057068
99,20,0,0.0,20,0,270996.51001472224,15.2,0.07637545936274312
100,27,2,0.07407407407407407,25,0,31484.99981996157,13.148148148148149,0.08606652621874086
101,16,1,0.0625,15,0,223086.8480504943,36.0,0.10893485027725412
102,31,2,0.06451612903225806,29,0,235350.52432004668,15.516129032258064,0.11067475392071192
103,18,1,0.05555555555555555,17,0,3139.137701119023,12.444444444444445,0.10068770930104652
104,23,0,0.0,23,0,118941.24459665781,179.0,0.12650523845790015
105,16,3,0.1875,13,0,125995.3993852537,16.0,0.1051238425448312
106,23,1,0.043478260869565216,22,0,126312.95100359242,14.0,0.12695504554988632
107,12,0,0.0,12,0,60705.18038623052,17.583333333333332,0.09166232791075062
108,13,0,0.0,13,0,228257.74118581155,13.23076923076923,0.12660630511688015
109,23,0,0.0,23,0,162316.4994885476,17.565217391304348,0.10420871588734201
110,26,3,0.11538461538461539,23,0,69520.9591590636,20.615384615384617,0.08194782295424957
111,34,1,0.029411764705882353,33,0,41989.18978163757,27.735294117647058,0.10726397999739301
112,16,4,0.25,12,0,13847.257668841536,12.0,0.12675619825447235
113,16,1,0.0625,15,0,58573.88433592353,11.875,0.10328879354609438
114,21,2,0.09523809523809523,19,0,36516.43595835268,15.142857142857142,0.11220314611202767
115,30,1,0.03333333333333333,29,0,88.52535229563614,56.63333333333333,0.11178750343162
116,23,2,0.08695652173913043,21,0,1911.699245244977,115.34782608695652,0.09730853505040675
117,36,1,0.027777777777777776,35,0,197699.69651676586,20.166666666666668,0.10604908979714267
118,27,2,0.07407407407407407,25,0,37524.62150498787,55.7037037037037,0.09987669727902491
119,27,0,0.0,27,0,24004.553849278916,15.11111111111111,0.10359772863251417
120,20,0,0.0,20,0,67191.26290307837,198.05,0.1524203419761808
121,39,3,0.07692307692307693,36,0,57820.54664228978,60.30769230769231,0.11440528530356922
122,81,3,0.037037037037037035,78,0,202458.00820960785,18.753086419753085,0.09460204060377977
123,17,2,0.11764705882352941,15,0,230276.76462035786,27.0,0.11757885889576772
124,48,5,0.10416666666666667,43,0,45524.799034614836,38.875,0.0856816358491171
125,31,1,0.03225806451612903,30,0,1398.707852604656,19.903225806451612,0.08935330992051826
126,19,1,0.05263157894736842,18,0,106199.65915924706,23.842105263157894,0.12245978074980142
127,22,1,0.045454545454545456,21,0,36951.17021011051,14.181818181818182,0.11364476779069607
128,78,3,0.038461538461538464,75,0,290773.63267440005,17.423076923076923,0.0983961964537001
129,14,1,0.07142857142857142,13,0,51702.46078334368,748.3571428571429,0.15891640693078632
130,21,0,0.0,21,0,17653.602285357105,8.428571428571429,0.08466060619209502
131,18,1,0.05555555555555555,17,0,360797.0548166387,25.944444444444443,0.1283239104877144
132,31,5,0.16129032258064516,26,0,8625.427046481846,16.096774193548388,0.10712423899859505
133,14,1,0.07142857142857142,13,0,121204.7640999421,11.928571428571429,0.10496953008240033
134,30,3,0.1,27,0,339571.3329779258,45.53333333333333,0.12212326674481333
135,20,3,0.15,17,0,47776.56259285517,11.4,0.09759375753877206
136,20,0,0.0,20,0,145627.53713151693,19.55,0.10707557584040747
137,17,0,0.0,17,0,109910.24625299226,134.41176470588235,0.12256472703447627
138,18,2,0.1111111111111111,16,0,322730.605576348,80.66666666666667,0.12565423819229748
139,33,4,0.12121212121212122,29,0,426446.8497818934,37.93939393939394,0.10931656628843955
140,13,0,0.0,13,0,973.5945731925351,22.23076923076923,0.10606307037430594
141,43,3,0.06976744186046512,40,0,24473.023608542502,19.627906976744185,0.09519409990889265
142,36,3,0.08333333333333333,33,0,76710.39863401419,49.5,0.1003244234582254
143,26,1,0.038461538461538464,25,0,305507.5876834171,20.76923076923077,0.11595656184740898
144,48,3,0.0625,45,0,703772.5223075821,35.520833333333336,0.12480483208380828
145,23,1,0.043478260869565216,22,0,76763.15795106227,30.304347826086957,0.09899779643144069
146,20,3,0.15,17,0,589025.1300955185,28.45,0.09889962709771286
147,22,0,0.0,22,0,24159.129677586807,12.409090909090908,0.1194275015827711
148,35,3,0.08571428571428572,32,0,155649.59426985873,43.371428571428574,0.10069822393312945
149,24,1,0.041666666666666664,23,0,29627.724894198327,19.875,0.11504257634736166
150,43,3,0.06976744186046512,40,0,285117.28600359755,22.27906976744186,0.1178520047039481
151,27,3,0.1111111111111111,24,0,31574.78063139134,25.703703703703702,0.1044201560097574
152,49,2,0.04081632653061224,47,0,62504.126807452594,21.142857142857142,0.10828193942792172
153,14,1,0.07142857142857142,13,0,80338.63286599956,114.71428571428571,0.13941644010900892
154,54,0,0.0,54,0,864.0071906084561,380.6666666666667,0.13411405823721395
155,19,1,0.05263157894736842,18,0,5508.189368261486,18.63157894736842,0.11814870510046123
156,16,1,0.0625,15,0,26079.99652756967,34.875,0.097695807275746
157,18,0,0.0,18,0,55897.15579333598,29.166666666666668,0.10149484642318228
158,14,1,0.07142857142857142,13,0,6624.610736321675,14.428571428571429,0.08850369521158108
159,24,3,0.125,21,0,27.903342888184643,17.416666666666668,0.09845908971982952
160,30,1,0.03333333333333333,29,0,18109.408671017132,52.166666666666664,0.11152607121351668
161,27,3,0.1111111111111111,24,0,96464.6767680197,22.59259259259259,0.09346465709099291
162,69,6,0.08695652173913043,63,0,216930.91523433322,49.20289855072464,0.11741002314368698
163,23,3,0.13043478260869565,20,0,22597.68455060715,17.347826086956523,0.1204894387144866
164,26,1,0.038461538461538464,25,0,2551.719698596244,39.73076923076923,0.12945745750098525
165,36,2,0.05555555555555555,34,0,58523.07987289838,26.52777777777778,0.10166936615148704
166,28,3,0.10714285714285714,25,0,41526.88857926842,179.78571428571428,0.12179589443679593
167,28,1,0.03571428571428571,27,0,5145.440786222251,32.035714285714285,0.10106151367867289
168,16,0,0.0,16,0,31863.306373589276,86.25,0.13910958998933415
169,22,2,0.09090909090909091,20,0,6588.955821562334,14.272727272727273,0.12246521099564239
170,20,1,0.05,19,0,57373.49807865634,113.0,0.13912846597566453
171,19,1,0.05263157894736842,18,0,56033.426551029464,12.31578947368421,0.13490595546703799
172,246,16,0.06504065040650407,230,0,291768.99184220616,20.349593495934958,0.1179930532937014
173,44,1,0.022727272727272728,43,0,22825.075527439625,25.181818181818183,0.10576998694377825
174,103,8,0.07766990291262135,95,0,126525.93347810984,31.49514563106796,0.10928526217857991
175,43,4,0.09302325581395349,39,0,146268.8841223116,18.953488372093023,0.10492187816003215
176,25,0,0.0,25,0,599846.8148806657,386.96,0.12984782579175036
177,16,0,0.0,16,0,29.918223338593364,191.625,0.12628422767558417
178,31,6,0.1935483870967742,25,0,19101.50894748931,12.35483870967742,0.10173315039475526
179,32,0,0.0,32,0,41617.35778578298,48.09375,0.10512420635467916
180,25,0,0.0,25,0,201582.8535701479,15.64,0.09283207437025781
181,28,2,0.07142857142857142,26,0,7983.562282380185,62.642857142857146,0.09704805009034127
182,13,1,0.07692307692307693,12,0,14743.062383444367,174.69230769230768,0.11977425024072788
183,16,2,0.125,14,0,8227.036775818673,14.5625,0.09390742833776614
184,18,0,0.0,18,0,25531.535054541855,12.944444444444445,0.0819417290301287
185,44,2,0.045454545454545456,42,0,213878.04671366754,18.795454545454547,0.11509426341369439
186,190,10,0.05263157894736842,180,0,255229.56956119798,20.86315789473684,0.11231274557026234
187,23,4,0.17391304347826086,19,0,118946.23783189642,24.304347826086957,0.11483465412475684
188,22,1,0.045454545454545456,21,0,227.36695637301963,89.5909090909091,0.12316050202381185
189,98,3,0.030612244897959183,95,0,85152.10413140933,19.948979591836736,0.11081753817096723
190,24,2,0.08333333333333333,22,0,83282.09530549753,23.416666666666668,0.08026103129607483
191,18,2,0.1111111111111111,16,0,1934.3236052203279,34.888888888888886,0.11432627573687583
192,23,1,0.043478260869565216,22,0,3960.0896870334363,25.82608695652174,0.07076049966075458
193,32,2,0.0625,30,0,1042.841211932642,443.84375,0.14213975771670403
194,20,0,0.0,20,0,6018.400000000013,17.85,0.1082911910133488
195,14,1,0.07142857142857142,13,0,189.79292713744965,157.78571428571428,0.14572225216012782
196,23,2,0.08695652173913043,21,0,322321.23739822826,22.043478260869566,0.12411240295914844
197,25,0,0.0,25,0,55498.27846592326,32.88,0.1097489467117554
198,19,2,0.10526315789473684,17,0,617951.7280757859,39.63157894736842,0.10159887211675622
199,29,0,0.0,29,0,86633.06034390141,133.72413793103448,0.12820314940785033
200,17,2,0.11764705882352941,15,0,24343.99208634332,140.23529411764707,0.1110371784020307
201,40,2,0.05,38,0,151528.3497281888,15.65,0.1270847996928318
202,23,0,0.0,23,0,52311.738986465745,63.17391304347826,0.12191283385370681
203,19,1,0.05263157894736842,18,0,4834.959015958758,21.05263157894737,0.10946656064440634
204,17,0,0.0,17,0,0.0,15.352941176470589,0.08271009490708772
205,90,2,0.022222222222222223,88,0,421113.75729150284,30.5,0.11407667075844087
206,14,0,0.0,14,0,123511.8336932876,30.714285714285715,0.11315209158718462
207,25,0,0.0,25,0,11505.840777404082,38.68,0.12269849737627568
208,25,2,0.08,23,0,11376.529352197747,21.24,0.10266960343394738
209,46,2,0.043478260869565216,44,0,21416.25340127039,23.043478260869566,0.0937981887816158
210,34,4,0.11764705882352941,30,0,263147.0453317127,83.3529411764706,0.10217122288942984
211,14,2,0.14285714285714285,12,0,33925.60236188284,115.57142857142857,0.12079069294689627
212,15,2,0.13333333333333333,13,0,16047.466666666667,19.2,0.12884725072284683
213,35,5,0.14285714285714285,30,0,43209.699396959295,133.65714285714284,0.10026457376532424
214,19,0,0.0,19,0,23890.16982620352,31.36842105263158,0.12639701999916686
215,12,0,0.0,12,0,15593.285640294547,12.083333333333334,0.10591474043901693
216,36,2,0.05555555555555555,34,0,121428.60343739408,118.41666666666667,0.13330376827232435
217,30,2,0.06666666666666667,28,0,56138.99054172145,21.0,0.10074518802489182
218,33,3,0.09090909090909091,30,0,90093.89644213696,18.333333333333332,0.09855824077316501
219,24,0,0.0,24,0,14469.912559587836,28.833333333333332,0.10323959636701803
220,54,3,0.05555555555555555,51,0,171612.42745874828,26.59259259259259,0.12268863544519701
221,17,2,0.11764705882352941,15,0,2208.5496646272636,11.0,0.08421748642127881
222,11,0,0.0,11,0,76569.45454545454,21.363636363636363,0.12810496157043613
223,41,1,0.024390243902439025,40,0,40374.40719479656,139.1951219512195,0.10516288377752184
224,17,0,0.0,17,0,35451.07335149909,38.0,0.1062989255461364
225,59,7,0.11864406779661017,52,0,57759.34529190092,42.57627118644068,0.10586029861796639
226,20,0,0.0,20,0,4456.46679461147,15.6,0.10384042449815467
227,20,0,0.0,20,0,198863.14411505847,79.9,0.12138665940436803
228,36,3,0.08333333333333333,33,0,222798.84139933766,33.27777777777778,0.1248913451732744
229,42,3,0.07142857142857142,39,0,51686.67726204466,15.5,0.09107405031270914
230,17,1,0.058823529411764705,16,0,0.0,17.529411764705884,0.11256083156483827
231,11,0,0.0,11,0,6212.58349166878,19.272727272727273,0.10974155734227019
232,28,1,0.03571428571428571,27,0,118490.9666587613,38.82142857142857,0.10988566444700956
233,16,2,0.125,14,0,11857.949295169981,12.3125,0.08633860449411193
234,22,1,0.045454545454545456,21,0,494259.65955060866,16.954545454545453,0.1052625414207435
235,22,1,0.045454545454545456,21,0,25641.15094173441,19.454545454545453,0.09541853534701072
236,34,0,0.0,34,0,115785.00849845103,23.11764705882353,0.12693706598179968
237,22,0,0.0,22,0,11112.764614202566,37.54545454545455,0.09114655509425006
238,24,1,0.041666666666666664,23,0,423094.03556277876,17.708333333333332,0.11344851653953629
239,13,0,0.0,13,0,19731.721358854797,47.30769230769231,0.09274564353982705
240,38,1,0.02631578947368421,37,0,49643.82596047294,23.210526315789473,0.12313792500122149
241,13,0,0.0,13,0,7791.766518601724,29.23076923076923,0.11182283198343154
242,21,0,0.0,21,0,29059.00606283736,17.761904761904763,0.11934092696046926
243,12,0,0.0,12,0,0.0,17.083333333333332,0.10578438587082618
244,15,2,0.13333333333333333,13,0,0.0,39.53333333333333,0.12405075765109509
245,24,1,0.041666666666666664,23,0,53524.64960857841,13.291666666666666,0.11321488614634012
246,16,0,0.0,16,0,8170.875147557085,13.3125,0.10275231656565385
247,15,1,0.06666666666666667,14,0,23992.342781708718,12.2,0.1056525973782025
248,33,2,0.06060606060606061,31,0,5387.67905112589,14.636363636363637,0.07640765974750925
249,29,1,0.034482758620689655,28,0,22280.18106020476,33.96551724137931,0.10528326498179072
250,13,0,0.0,13,0,39702.56157994435,13.153846153846153,0.0856641161312277
251,29,3,0.10344827586206896,26,0,107384.23759063844,171.79310344827587,0.13659919805852508
252,17,0,0.0,17,0,27999.049641434103,10.705882352941176,0.09149544577662734
253,16,1,0.0625,15,0,118131.55314435414,15.5625,0.11688281455252646
254,17,0,0.0,17,0,10277.415287611555,27.529411764705884,0.10753836812031778
255,23,1,0.043478260869565216,22,0,35623.4938474234,10.391304347826088,0.0981161053419328
256,22,2,0.09090909090909091,20,0,33589.06079217008,32.31818181818182,0.10645289403641028
257,12,1,0.08333333333333333,11,0,85484.48710049788,25.416666666666668,0.1146402199497632
258,15,1,0.06666666666666667,14,0,6137.084587635505,8.866666666666667,0.10013904437425472
259,11,0,0.0,11,0,0.0,15.727272727272727,0.09193234713019692
260,25,2,0.08,23,0,56375.88797215054,19.04,0.10463623932235962
261,23,1,0.043478260869565216,22,0,23350.22526950758,14.347826086956522,0.11920976187321966
262,22,0,0.0,22,0,62998.69588957361,112.22727272727273,0.1129959160414788
263,31,2,0.06451612903225806,29,0,24910.474472612885,22.0,0.11937864323508338
264,58,3,0.05172413793103448,55,0,101825.76912962586,17.79310344827586,0.11932141362510151
265,37,3,0.08108108108108109,34,0,115058.0012655379,17.243243243243242,0.10667856939037164
266,22,1,0.045454545454545456,21,0,27189.961949389857,12.863636363636363,0.10394394867784135
267,26,1,0.038461538461538464,25,0,78916.96910968861,145.46153846153845,0.11778282837069723
268,26,1,0.038461538461538464,25,0,79086.38196575134,14.384615384615385,0.11363829150382711
269,25,3,0.12,22,0,7377.78227785135,66.16,0.11195682364299406
270,17,0,0.0,17,0,94552.49372859338,25.58823529411765,0.11130835463836022
271,22,2,0.09090909090909091,20,0,0.1684419116237298,22.772727272727273,0.08676346576262427
272,26,2,0.07692307692307693,24,0,91426.88756786735,14.076923076923077,0.10016320573118596
273,28,4,0.14285714285714285,24,0,4088.633269606557,11.071428571428571,0.09813817082749078
274,37,3,0.08108108108108109,34,0,42037.343126426094,145.59459459459458,0.10350871905345517
275,15,0,0.0,15,0,40327.34850265558,19.866666666666667,0.10490192257104648
276,16,1,0.0625,15,0,91631.30033474197,28.0,0.11257134111285523
277,24,0,0.0,24,0,2879.7313412933786,195.29166666666666,0.1055995331989139
278,18,3,0.16666666666666666,15,0,1778.509942103326,208.0,0.13741630270330454
279,30,1,0.03333333333333333,29,0,18318.582424947806,283.8,0.10535579758394542
280,13,0,0.0,13,0,0.0515542713542652,123.07692307692308,0.1297463502351287
281,140,7,0.05,133,0,723827.7201462272,25.05,0.1201342260900596
282,21,1,0.047619047619047616,20,0,103.54415371420848,20.857142857142858,0.1020416013590404
283,24,0,0.0,24,0,88221.38423290725,20.541666666666668,0.1062133285316329
284,19,1,0.05263157894736842,18,0,11288.648427806884,25.94736842105263,0.08369645742293824
285,19,1,0.05263157894736842,18,0,66752.71299140259,84.10526315789474,0.097664501824614
286,19,1,0.05263157894736842,18,0,26849.930355407672,28.36842105263158,0.10440397647371978
287,16,2,0.125,14,0,11714.949280017405,12.1875,0.10612993675936437
288,20,1,0.05,19,0,21505.684500132185,16.0,0.1101280647096482
289,15,2,0.13333333333333333,13,0,163258.84187793956,30.533333333333335,0.11878788930060907
290,17,1,0.058823529411764705,16,0,71057.38552595675,16.941176470588236,0.12035472246683959
291,29,0,0.0,29,0,98807.71076836137,171.89655172413794,0.1133999901868089
292,17,0,0.0,17,0,3691.9295575679557,37.705882352941174,0.11228420553849847
293,26,0,0.0,26,0,2418.1318167513755,66.0,0.09688257812729631
294,12,1,0.08333333333333333,11,0,14124.351123014028,10.583333333333334,0.08605951557657521
295,25,0,0.0,25,0,51186.74212312482,11.56,0.10319584425447462
296,24,1,0.041666666666666664,23,0,52804.158994612575,48.666666666666664,0.13298247346977585
297,36,3,0.08333333333333333,33,0,188855.38289280038,26.583333333333332,0.09917176211906395
298,22,2,0.09090909090909091,20,0,21845.371707240647,28.545454545454547,0.08961002451910513
299,21,0,0.0,21,0,38431.35201940269,14.761904761904763,0.0946187744919015
300,17,1,0.058823529411764705,16,0,0.0,34.35294117647059,0.07636897891856635
301,12,1,0.08333333333333333,11,0,82990.79780477614,39.583333333333336,0.11956507503763915
302,11,0,0.0,11,0,74012.63463319674,34.81818181818182,0.08800648215974351
303,15,2,0.13333333333333333,13,0,16624.35744891145,181.93333333333334,0.12135645304816824
304,27,3,0.1111111111111111,24,0,10541.952310940704,65.18518518518519,0.11603635391230166
305,65,2,0.03076923076923077,63,0,264652.26471958176,21.338461538461537,0.09278275707120599
306,24,3,0.125,21,0,54179.36147799171,11.375,0.09112012805744858
307,16,0,0.0,16,0,312.10895285837734,122.6875,0.1320232369378303
308,22,1,0.045454545454545456,21,0,1037.2027114562188,15.181818181818182,0.10766839474273117
309,28,1,0.03571428571428571,27,0,35789.367807835086,13.0,0.08789856692514604
310,36,1,0.027777777777777776,35,0,311389.0111245501,19.916666666666668,0.0747058806301542
311,14,3,0.21428571428571427,11,0,189.69718349064888,108.92857142857143,0.08410265193692434
312,16,0,0.0,16,0,86572.04825745085,16.6875,0.11602434643650147
313,29,0,0.0,29,0,70557.91917611648,54.06896551724138,0.11085639399516879
314,20,1,0.05,19,0,278587.1507559675,141.75,0.090121229881638
315,33,3,0.09090909090909091,30,0,147218.33341892777,150.78787878787878,0.14027940807803815
316,44,2,0.045454545454545456,42,0,132793.67300224074,18.75,0.11523593306359227
317,13,1,0.07692307692307693,12,0,39112.637099090934,21.53846153846154,0.09913290422220425
318,37,2,0.05405405405405406,35,0,41190.26021660798,276.3243243243243,0.12842088227081208
319,16,0,0.0,16,0,25000.955612162565,26.375,0.08530497495144054
320,16,1,0.0625,15,0,6524.255385250378,10.3125,0.09710114644691417
321,22,1,0.045454545454545456,21,0,24489.795947948718,20.318181818181817,0.11042482312674155
322,11,0,0.0,11,0,0.0,22.818181818181817,0.10217536085227757
323,20,1,0.05,19,0,48823.49068799569,15.9,0.10129591064276748
324,13,0,0.0,13,0,1089.3001914793263,288.0769230769231,0.1262596173066124
325,70,5,0.07142857142857142,65,0,6244.948731264977,37.357142857142854,0.10537351994599573
326,21,0,0.0,21,0,59166.50600108983,24.714285714285715,0.11819618529770158
327,21,0,0.0,21,0,61884.685472308345,17.857142857142858,0.12583489534240208
328,18,2,0.1111111111111111,16,0,3333.1887479350908,16.444444444444443,0.10260035947909259
329,18,2,0.1111111111111111,16,0,134703.36873634884,35.22222222222222,0.12532359950845173
330,14,1,0.07142857142857142,13,0,43243.16962599019,22.071428571428573,0.08790916776265881
331,20,0,0.0,20,0,0.0,45.1,0.10498281920092283
332,22,3,0.13636363636363635,19,0,9374.69731185688,13.590909090909092,0.08603048643373436
333,24,3,0.125,21,0,268342.34832517436,15.583333333333334,0.08693399205879526
334,16,0,0.0,16,0,174770.73677504022,124.4375,0.14734301395330834
335,19,2,0.10526315789473684,17,0,84788.37166646101,200.21052631578948,0.13171910259097327
336,17,0,0.0,17,0,83137.31125570869,27.764705882352942,0.09715929175097589
337,13,0,0.0,13,0,37912.01557966744,119.46153846153847,0.11551413467305617
338,38,3,0.07894736842105263,35,0,54047.6310077006,26.07894736842105,0.11779359149331278
339,11,0,0.0,11,0,1207.1638949404928,534.1818181818181,0.15325758858494298
340,14,0,0.0,14,0,0.0,33.285714285714285,0.1277109534976681
341,30,0,0.0,30,0,27249.684398639503,45.96666666666667,0.11113314102693957
342,38,4,0.10526315789473684,34,0,150387.69183315543,69.78947368421052,0.1183326901419643
343,23,2,0.08695652173913043,21,0,18487.081946755647,15.91304347826087,0.09421312792988676
344,17,1,0.058823529411764705,16,0,0.0,12.823529411764707,0.12500418079873082
345,13,1,0.07692307692307693,12,0,0.0,13.307692307692308,0.08538281502884894
346,23,2,0.08695652173913043,21,0,297195.1341313024,21.217391304347824,0.11641665474362538
347,14,1,0.07142857142857142,13,0,265776.79841868265,15.214285714285714,0.12365638532939012
348,16,1,0.0625,15,0,44393.5144189106,15.125,0.12107098228343191
349,11,0,0.0,11,0,8581.426565885607,33.72727272727273,0.07813316433430299
350,16,1,0.0625,15,0,0.0,15.0,0.08963567711052439
351,15,1,0.06666666666666667,14,0,36950.41523203625,15.666666666666666,0.1151704084817439
352,14,0,0.0,14,0,10803.717870092574,13.285714285714286,0.11600281635537132
353,23,1,0.043478260869565216,22,0,227.93361508528534,21.956521739130434,0.09792755628132246
354,32,1,0.03125,31,0,3093.5864892270793,19.96875,0.10406287270485687
355,12,0,0.0,12,0,371.9535075805082,19.0,0.09123045232244513
356,13,1,0.07692307692307693,12,0,36147.61029598704,18.076923076923077,0.12448661812053463
357,22,0,0.0,22,0,6268.240224959206,15.772727272727273,0.10700385417270285
358,23,2,0.08695652173913043,21,0,101314.0609283785,14.08695652173913,0.09253177784414283
359,16,4,0.25,12,0,7712.199614522068,81.0,0.09624200968044264
360,31,1,0.03225806451612903,30,0,81930.62108092148,24.193548387096776,0.11662369438290619
361,20,0,0.0,20,0,578.968092825192,30.45,0.09583094743700141
362,25,1,0.04,24,0,106.23042275476337,69.52,0.08938838753536124
363,31,1,0.03225806451612903,30,0,3095.0541066695228,51.354838709677416,0.11531869115589999
364,23,2,0.08695652173913043,21,0,82279.67149408688,366.69565217391306,0.14027524747637637
365,20,1,0.05,19,0,2440.890663377554,31.55,0.11380397644068552
366,31,0,0.0,31,0,15760.9308336236,11.064516129032258,0.10860276339844269
367,25,0,0.0,25,0,4142.813121845158,62.4,0.11254348353345177
368,17,1,0.058823529411764705,16,0,1434.4325348425161,54.588235294117645,0.11748221466403283
369,21,0,0.0,21,0,8994.87043685743,83.95238095238095,0.11965446015150068
370,13,2,0.15384615384615385,11,0,23329.5322615855,23.23076923076923,0.11480128283122154
371,55,2,0.03636363636363636,53,0,87632.53944882285,16.654545454545456,0.11019700923924851
372,24,2,0.08333333333333333,22,0,38052.90431063966,80.33333333333333,0.09069950240974632
373,41,4,0.0975609756097561,37,0,90176.36814067954,18.24390243902439,0.10562817143995495
374,12,2,0.16666666666666666,10,0,0.0,27.083333333333332,0.11279096342967655
375,41,2,0.04878048780487805,39,0,64.77464802119718,46.02439024390244,0.10280705883953778
376,21,1,0.047619047619047616,20,0,11018.686099429897,21.714285714285715,0.11353310639131242
377,13,1,0.07692307692307693,12,0,6579.567079655609,12.538461538461538,0.09063474526778782
378,26,1,0.038461538461538464,25,0,242080.01890422916,17.576923076923077,0.12002371208803228
379,18,0,0.0,18,0,374573.79981478915,29.055555555555557,0.13830396399858405
380,64,4,0.0625,60,0,171776.6875635603,23.328125,0.11646064150204805
381,25,2,0.08,23,0,4672.9532379062675,87.44,0.1225150522378183
382,18,3,0.16666666666666666,15,0,260885.9574241124,20.055555555555557,0.11337842576806308
383,11,3,0.2727272727272727,8,0,70815.91819170765,19.0,0.12270966225572985
384,14,0,0.0,14,0,50846.8575725757,202.5,0.11561728725846318
385,25,2,0.08,23,0,110121.61370593696,14.64,0.09520028785768231
386,31,1,0.03225806451612903,30,0,26163.470717565102,9.32258064516129,0.10779213398598071
387,15,1,0.06666666666666667,14,0,34284.12933066078,11.8,0.09201489833006109
388,20,2,0.1,18,0,67489.32019757881,22.8,0.11794905168049666
389,17,0,0.0,17,0,0.0,14.235294117647058,0.09914041807523788
390,20,0,0.0,20,0,31456.184468948457,10.0,0.0767647924401652
391,21,2,0.09523809523809523,19,0,13588.602132540573,322.8095238095238,0.14442636497800104
392,22,3,0.13636363636363635,19,0,21631.953727244665,10.272727272727273,0.09718298831172413
393,23,0,0.0,23,0,76429.89203215488,22.347826086956523,0.09240424997903926
394,30,5,0.16666666666666666,25,0,66522.50694742991,24.233333333333334,0.0772088966266135
395,23,1,0.043478260869565216,22,0,33120.324363982196,20.043478260869566,0.08240121894368686
396,24,2,0.08333333333333333,22,0,28342.29800432552,19.708333333333332,0.10792754298735298
397,27,2,0.07407407407407407,25,0,248263.8884757964,117.81481481481481,0.10686000529708746
398,11,0,0.0,11,0,0.0,14.727272727272727,0.1013981210761611
399,23,1,0.043478260869565216,22,0,198323.4052645382,24.130434782608695,0.09946297202098493
400,22,2,0.09090909090909091,20,0,206357.2541074968,87.4090909090909,0.1350160128239171
401,22,0,0.0,22,0,16379.020795855451,61.63636363636363,0.11331472502669258
402,14,0,0.0,14,0,0.0,27.5,0.07956557608464734
403,13,0,0.0,13,0,11694.63764592779,10.0,0.08637659329101857
404,83,5,0.060240963855421686,78,0,106927.4673947807,33.08433734939759,0.11832972245989923
405,23,2,0.08695652173913043,21,0,12816.498995550086,13.0,0.11222279014363039
406,48,4,0.08333333333333333,44,0,80719.29350543875,113.35416666666667,0.1160404163900877
407,24,1,0.041666666666666664,23,0,73068.66036517387,15.416666666666666,0.08776312375219525
408,20,2,0.1,18,0,16815.926817957465,195.2,0.11767522705038824
409,46,1,0.021739130434782608,45,0,8035.723764975257,232.84782608695653,0.1384197377342844
410,11,0,0.0,11,0,1166.7349567847655,328.09090909090907,0.12584388154517734
411,26,2,0.07692307692307693,24,0,34516.74926719806,17.26923076923077,0.11608893472589842
412,20,1,0.05,19,0,74108.47906811842,15.2,0.10889007282272081
413,14,1,0.07142857142857142,13,0,0.0,22.285714285714285,0.08831653531386854
414,34,1,0.029411764705882353,33,0,31208.68043120934,27.852941176470587,0.12146182637592318
415,45,1,0.022222222222222223,44,0,256856.73804280846,15.88888888888889,0.09491663190858789
416,41,1,0.024390243902439025,40,0,132884.5669480239,29.414634146341463,0.10758283728069101
417,11,0,0.0,11,0,8329.098215620439,16.90909090909091,0.07349967855159549
418,18,1,0.05555555555555555,17,0,61819.01265795627,20.833333333333332,0.10585758745280398
419,27,2,0.07407407407407407,25,0,81471.11246287405,16.85185185185185,0.11505764653030337
420,43,2,0.046511627906976744,41,0,7431.627136839158,90.62790697674419,0.0994368616058363
421,27,1,0.037037037037037035,26,0,739.598404975819,67.37037037037037,0.11478452947592103
422,24,0,0.0,24,0,18358.39524005706,21.666666666666668,0.11441568166722633
423,13,2,0.15384615384615385,11,0,175134.72852417052,22.23076923076923,0.1166821781715081
424,12,1,0.08333333333333333,11,0,140793.23571086902,44.75,0.1338860454950093
425,18,1,0.05555555555555555,17,0,29837.13429088321,82.0,0.11214077579207436
426,41,1,0.024390243902439025,40,0,74967.48215981635,23.21951219512195,0.09810812804415933
427,29,2,0.06896551724137931,27,0,29029.133128006208,208.55172413793105,0.0902234385012816
428,15,0,0.0,15,0,406230.2934742544,27.6,0.13284538765696255
429,118,9,0.07627118644067797,109,0,423733.37614071055,27.050847457627118,0.1320357943972516
430,41,3,0.07317073170731707,38,0,27194.393156964674,34.09756097560975,0.10050101861028149
431,19,1,0.05263157894736842,18,0,6349.310221240431,241.78947368421052,0.13030479522626698
432,28,1,0.03571428571428571,27,0,21022.047835763027,19.428571428571427,0.11156417869716126
433,21,0,0.0,21,0,118857.61783935002,14.047619047619047,0.11315968165524877
434,19,2,0.10526315789473684,17,0,0.028708133971291863,9.68421052631579,0.08599238743516975
435,36,2,0.05555555555555555,34,0,78591.13236978893,26.61111111111111,0.12242668276096655
436,14,0,0.0,14,0,1737.144481661083,16.571428571428573,0.10128974363113373
437,14,1,0.07142857142857142,13,0,36459.366423982356,26.071428571428573,0.10916151830479714
438,13,0,0.0,13,0,0.0,14.538461538461538,0.11348790533642884
439,25,1,0.04,24,0,9743.75828496594,20.04,0.11486272215155427
440,20,3,0.15,17,0,7593.234830967044,20.85,0.08850231866162685
441,16,3,0.1875,13,0,203489.85466569665,13.6875,0.1294085801110767
442,13,0,0.0,13,0,79754.37976919909,14.846153846153847,0.10420196246685848
443,11,0,0.0,11,0,0.0,7.2727272727272725,0.059115750984650564
444,13,1,0.07692307692307693,12,0,1887.5101229905342,19.0,0.11983500032811964
445,24,0,0.0,24,0,20122.85981031487,16.416666666666668,0.10162031523835176
446,35,1,0.02857142857142857,34,0,84398.17558832829,24.857142857142858,0.1132623443367804
447,18,0,0.0,18,0,0.0,14.88888888888889,0.12614950638975506
448,23,4,0.17391304347826086,19,0,8407.140601757681,64.95652173913044,0.09998588407527415
449,18,0,0.0,18,0,320968.37327707995,15.722222222222221,0.08834967049214235
450,15,3,0.2,12,0,17032.07806693375,18.333333333333332,0.11203919993927625
451,13,1,0.07692307692307693,12,0,472.7996597492187,10.23076923076923,0.08027333523601413
452,13,0,0.0,13,0,137970.5787323821,20.0,0.11652004873551738
453,18,1,0.05555555555555555,17,0,0.03723364042252487,27.22222222222222,0.09431613721239687
454,14,1,0.07142857142857142,13,0,207962.81368088094,29.071428571428573,0.10944362086536812
455,23,2,0.08695652173913043,21,0,13133.565203815408,12.91304347826087,0.09022272608025396
456,18,2,0.1111111111111111,16,0,0.03723364042252487,37.666666666666664,0.08872608699612801
457,29,1,0.034482758620689655,28,0,8254.787859974986,30.103448275862068,0.09259156634525616
458,47,3,0.06382978723404255,44,0,18397.70069021451,132.2127659574468,0.1243441762067683
459,29,1,0.034482758620689655,28,0,14242.773419317324,26.586206896551722,0.10899074739657937
460,20,0,0.0,20,0,145671.65369017125,18.2,0.10614361041311857
461,11,0,0.0,11,0,6626.475272389726,229.1818181818182,0.069143218119612
462,21,0,0.0,21,0,30150.65750668691,13.476190476190476,0.11633457145756837
463,15,0,0.0,15,0,35907.19764506164,16.4,0.10927223175458758
464,17,0,0.0,17,0,2654.0443305615704,84.47058823529412,0.1013589974155905
465,21,0,0.0,21,0,22077.002913104116,60.19047619047619,0.12155979323176808
466,25,1,0.04,24,0,118371.32219882574,17.44,0.12078682763200169
467,13,0,0.0,13,0,13894.744595909433,27.384615384615383,0.09343305470086762
468,21,0,0.0,21,0,12346.88404808854,24.095238095238095,0.11816635542189687
469,17,0,0.0,17,0,23142.141432510543,14.411764705882353,0.09691423119629819
470,11,1,0.09090909090909091,10,0,0.0,11.545454545454545,0.11063950272536204
471,23,4,0.17391304347826086,19,0,37934.27113859974,59.95652173913044,0.10680718090534701
472,28,4,0.14285714285714285,24,0,41746.27276512835,35.535714285714285,0.12060478474616092
473,19,2,0.10526315789473684,17,0,214717.96754387338,12.789473684210526,0.10415621913034406
474,18,2,0.1111111111111111,16,0,93838.94504474975,43.44444444444444,0.1149900064565602
475,30,2,0.06666666666666667,28,0,18303.57964698069,56.166666666666664,0.08783991935384466
476,26,0,0.0,26,0,38644.73217252338,44.23076923076923,0.12105594839188352
477,23,1,0.043478260869565216,22,0,11556.957293212936,16.652173913043477,0.09748044089099138
478,19,0,0.0,19,0,74562.77237428754,19.842105263157894,0.10809315880377524
479,22,1,0.045454545454545456,21,0,51569.12671101571,14.909090909090908,0.11301791991961435
480,40,1,0.025,39,0,116432.46332701587,45.325,0.11643925054972304
481,17,0,0.0,17,0,0.0,41.76470588235294,0.13466942699687606
482,12,1,0.08333333333333333,11,0,3887.6370093689857,187.25,0.11610903997748505
483,23,2,0.08695652173913043,21,0,697747.5283796333,69.78260869565217,0.10961389820562994
484,181,8,0.04419889502762431,173,0,341295.9994028169,18.066298342541437,0.11350549791186039
485,24,1,0.041666666666666664,23,0,366673.66928772844,72.83333333333333,0.1333557850400637
486,16,1,0.0625,15,0,50642.15997476031,49.875,0.12776229366632033
487,17,3,0.17647058823529413,14,0,27841.69745583933,17.176470588235293,0.1081647469943148
488,20,3,0.15,17,0,13389.979876523348,12.35,0.10537852277492768
489,16,1,0.0625,15,0,170552.9760460222,28.875,0.1002661450798577
490,20,1,0.05,19,0,164475.46195299653,16.15,0.08995665083420246
491,16,0,0.0,16,0,50122.487407908426,12.0,0.09932342819132191
492,21,2,0.09523809523809523,19,0,25322.58954368451,11.0,0.10872951815925144
493,26,2,0.07692307692307693,24,0,59802.80574120415,16.807692307692307,0.10833195444864148
494,17,2,0.11764705882352941,15,0,157492.54196389765,12.588235294117647,0.08014937326340853
495,21,4,0.19047619047619047,17,0,203274.08147631993,18.666666666666668,0.11666702030630581
496,12,2,0.16666666666666666,10,0,38590.291832592346,16.083333333333332,0.0996779784422442
497,63,2,0.031746031746031744,61,0,221685.03919032004,15.333333333333334,0.10613591985518106
498,33,2,0.06060606060606061,31,0,11396.871317142155,17.636363636363637,0.12440355829031423
499,15,3,0.2,12,0,14914.14698063325,20.8,0.1080724200233343
500,37,2,0.05405405405405406,35,0,309990.8738434298,32.4054054054054,0.1225784149318561
501,15,1,0.06666666666666667,14,0,47279.40782779719,121.26666666666667,0.1350744056672112
502,16,1,0.0625,15,0,3761.6875000000005,9.75,0.06680294609029301
503,21,0,0.0,21,0,111329.25226260371,14.047619047619047,0.08573854424792268
504,25,5,0.2,20,0,298133.9643702371,18.32,0.1166500791288419
505,42,2,0.047619047619047616,40,0,9997.094227390233,95.35714285714286,0.11152240371213724
506,15,0,0.0,15,0,100780.11008993503,15.533333333333333,0.1129875893181907
507,11,1,0.09090909090909091,10,0,0.0,15.909090909090908,0.14004709225019865
508,28,3,0.10714285714285714,25,0,25875.81834129192,20.821428571428573,0.10994798211046322
509,18,2,0.1111111111111111,16,0,56115.72926393556,27.666666666666668,0.13027486612827194
510,21,3,0.14285714285714285,18,0,96119.06882107153,19.238095238095237,0.10926195921900497
511,11,2,0.18181818181818182,9,0,250648.25499067912,260.45454545454544,0.16059542483801878
512,25,2,0.08,23,0,21597.174098878866,246.72,0.1165687732960632
513,27,1,0.037037037037037035,26,0,5285.4101851996675,15.74074074074074,0.09029120752101723
514,27,0,0.0,27,0,5768.322362128422,46.111111111111114,0.08924762001710136
515,16,2,0.125,14,0,19087.021174321108,20.5625,0.11348468120358254
516,18,3,0.16666666666666666,15,0,60746.798217795076,18.0,0.10666257343403261
517,22,3,0.13636363636363635,19,0,2735.636363636362,61.36363636363637,0.10250824613461264
518,16,1,0.0625,15,0,4.0,14.125,0.10675227966894549
519,30,2,0.06666666666666667,28,0,213404.86995891933,297.93333333333334,0.12159488336485569
520,19,1,0.05263157894736842,18,0,0.42105263157894735,32.36842105263158,0.09252986826965237
521,35,2,0.05714285714285714,33,0,312503.8686624941,75.0,0.12467433066810929
522,20,2,0.1,18,0,139748.2763451169,17.8,0.08879205185634036
523,19,1,0.05263157894736842,18,0,6149.866317538422,22.210526315789473,0.11966299357697438
524,15,1,0.06666666666666667,14,0,149365.5885832108,15.2,0.11169626957563249
525,16,0,0.0,16,0,137628.51836590996,17.0625,0.11862778355469444
526,21,1,0.047619047619047616,20,0,35417.02289997862,15.047619047619047,0.11967856696369224
527,14,1,0.07142857142857142,13,0,4298.905014680572,22.428571428571427,0.10503160179269562
528,23,2,0.08695652173913043,21,0,33512.84198604813,27.17391304347826,0.0976305479528467
529,29,0,0.0,29,0,35382.8645272132,16.620689655172413,0.09936320221729461
530,96,4,0.041666666666666664,92,0,292764.2893836492,28.3125,0.11357174256319573
531,15,0,0.0,15,0,4742.259514295508,8.466666666666667,0.05348663578122244
532,14,3,0.21428571428571427,11,0,12914.77768862122,16.642857142857142,0.10084676609030539
533,19,1,0.05263157894736842,18,0,51484.59140265189,50.31578947368421,0.08683009889621032
534,17,0,0.0,17,0,89265.46725639788,34.23529411764706,0.11066328800698905
535,15,1,0.06666666666666667,14,0,2709.36856941279,56.8,0.13153244609035578
536,12,1,0.08333333333333333,11,0,113793.59714154796,11.166666666666666,0.09203736949515669
537,12,0,0.0,12,0,1990.2784057763645,34.083333333333336,0.12902782595513396
538,25,2,0.08,23,0,22705.807014052807,17.04,0.09379207733397826
539,12,1,0.08333333333333333,11,0,663.940142217271,303.0833333333333,0.12984757307179476
540,11,0,0.0,11,0,28300.141849368196,328.6363636363636,0.13628470485053323
541,34,1,0.029411764705882353,33,0,246234.84538056148,25.058823529411764,0.09334372972932506
542,18,1,0.05555555555555555,17,0,52035.73011900022,14.555555555555555,0.09289647534699158
543,14,0,0.0,14,0,11780.60072722401,87.42857142857143,0.11623056342903683
544,23,2,0.08695652173913043,21,0,8779.798780056175,213.91304347826087,0.11588018879199838
545,15,2,0.13333333333333333,13,0,56465.68151926584,24.933333333333334,0.10268668601804502
546,25,2,0.08,23,0,83537.53963696393,54.92,0.0793013765615942
547,21,1,0.047619047619047616,20,0,541.6161072944811,234.76190476190476,0.12345009295132524
548,26,1,0.038461538461538464,25,0,105443.46735513468,479.2692307692308,0.15662425304903316
549,15,0,0.0,15,0,262491.1985179706,21.266666666666666,0.11494933427541706
550,17,1,0.058823529411764705,16,0,7080.235294117646,10.823529411764707,0.08371653141947838
551,20,0,0.0,20,0,7354.093028444195,76.0,0.11129695615039999
552,1668,99,0.05935251798561151,1569,0,3056.038510560558,28.664268585131893,0.10930781513396422
553,16,1,0.0625,15,0,146708.3775157144,88.5625,0.10681124458552546
554,14,1,0.07142857142857142,13,0,152444.11481166258,23.714285714285715,0.08907515533610454
555,16,1,0.0625,15,0,165.98503555431776,92.9375,0.08815049596494655
556,11,1,0.09090909090909091,10,0,0.0,10.909090909090908,0.09266276112755403
557,27,2,0.07407407407407407,25,0,1178.4947232224051,483.3333333333333,0.1428196567105528
558,17,0,0.0,17,0,7983.932244450254,51.35294117647059,0.07872470781735212
559,14,1,0.07142857142857142,13,0,306652.2826982174,21.214285714285715,0.1091757354806101
560,13,1,0.07692307692307693,12,0,3143.27166560251,130.76923076923077,0.1364213070306759
561,17,0,0.0,17,0,3878.0263178066157,13.529411764705882,0.06537435539583034
562,28,1,0.03571428571428571,27,0,93742.05726115419,25.321428571428573,0.09865617879647048
563,23,2,0.08695652173913043,21,0,29025.22933925667,15.869565217391305,0.09559850190562082
564,17,0,0.0,17,0,3425.720093122248,25.823529411764707,0.10027448276341135
565,20,1,0.05,19,0,243908.9363789347,17.25,0.1058424211556687
566,11,1,0.09090909090909091,10,0,789.9406895370583,122.9090909090909,0.09954290916269884
567,21,0,0.0,21,0,19936.27376891141,19.761904761904763,0.11967037418129371
568,13,0,0.0,13,0,32651.155959943837,102.76923076923077,0.11357100538825014
569,14,0,0.0,14,0,84834.20070426387,46.857142857142854,0.1098803867518848
570,16,3,0.1875,13,0,383.2299060384544,14.0,0.09813724179132904
571,20,1,0.05,19,0,33486.97849920173,530.6,0.15775346203102522
572,17,0,0.0,17,0,3258.197943406083,16.294117647058822,0.09920066116673877
573,20,3,0.15,17,0,8766.946036484795,39.75,0.10144502057708227
574,19,1,0.05263157894736842,18,0,4044.1151683579365,139.1578947368421,0.11477798290684975
575,22,2,0.09090909090909091,20,0,437184.9873480676,30.136363636363637,0.12474364291500661
576,26,0,0.0,26,0,25016.04037054856,68.5,0.08945395639334126
577,19,1,0.05263157894736842,18,0,71214.7628327493,45.31578947368421,0.10321604422674613
578,28,3,0.10714285714285714,25,0,36862.83177078174,15.214285714285714,0.09414220851947412
579,23,2,0.08695652173913043,21,0,67916.848361869,16.695652173913043,0.09862859494611213
580,11,0,0.0,11,0,27808.44935255542,14.454545454545455,0.11825485004095303
581,28,0,0.0,28,0,267845.6360861029,30.0,0.12308055825267497
582,33,1,0.030303030303030304,32,0,99513.29937407837,32.42424242424242,0.11429812709156913
583,12,1,0.08333333333333333,11,0,141634.13629962257,127.0,0.14065314282223218
584,14,0,0.0,14,0,0.0,199.57142857142858,0.1481906866515937
585,17,0,0.0,17,0,521.7172291267763,347.29411764705884,0.13966277856237722
586,16,1,0.0625,15,0,45439.619024743144,569.25,0.15235530699006997
587,18,1,0.05555555555555555,17,0,83288.0848004062,177.55555555555554,0.10546879225290912
588,15,3,0.2,12,0,4769.234139250637,88.33333333333333,0.09283874447147437
589,27,1,0.037037037037037035,26,0,4457.925925925935,31.85185185185185,0.1164381100905226
590,30,1,0.03333333333333333,29,0,32406.297050158253,13.833333333333334,0.08488109324301725
591,104,7,0.0673076923076923,97,0,221076.73023750487,18.53846153846154,0.11355204626946051
592,17,2,0.11764705882352941,15,0,0.004201680672268907,23.58823529411765,0.11952973943544476
593,25,1,0.04,24,0,205911.13374373384,16.28,0.10471685269946913
594,14,0,0.0,14,0,2871.472708340865,17.142857142857142,0.11234506956838661
595,14,2,0.14285714285714285,12,0,0.016806722689075633,14.785714285714286,0.10710742006035298
596,23,0,0.0,23,0,307.319206134935,127.1304347826087,0.1254229048953332
597,23,5,0.21739130434782608,18,0,134025.60368287907,23.217391304347824,0.09984850727371705
598,18,0,0.0,18,0,146158.22258442873,13.38888888888889,0.0817055648074164
599,12,2,0.16666666666666666,10,0,6317.438864544497,597.9166666666666,0.1676934540455769
600,24,2,0.08333333333333333,22,0,57010.61187001285,42.166666666666664,0.11090029151123644
601,22,0,0.0,22,0,129471.18596301448,17.863636363636363,0.10053211400324293
602,12,1,0.08333333333333333,11,0,41540.46038304996,17.166666666666668,0.1123410142033754
603,22,2,0.09090909090909091,20,0,6663.770954855316,13.545454545454545,0.11852552779885164
604,17,0,0.0,17,0,376798.18251953187,24.647058823529413,0.09282257414810573
605,22,2,0.09090909090909091,20,0,741.3917559511339,128.95454545454547,0.11699287345962128
606,22,3,0.13636363636363635,19,0,21537.533898740905,430.3636363636364,0.13679574443074563
607,14,2,0.14285714285714285,12,0,27073.58718802266,18.928571428571427,0.09157913010500465
608,20,4,0.2,16,0,5172.068011919544,16.15,0.10462523657881176
609,21,2,0.09523809523809523,19,0,96411.62374474629,76.47619047619048,0.1194416162726365
610,33,1,0.030303030303030304,32,0,277024.2664881799,150.03030303030303,0.11355263128433885
611,16,2,0.125,14,0,51331.286375309115,37.1875,0.10688722074456845
612,42,0,0.0,42,0,190848.1445201417,35.07142857142857,0.10928082645303454
613,47,2,0.0425531914893617,45,0,348158.61047685036,42.851063829787236,0.12371052656578603
614,16,0,0.0,16,0,69379.32004514881,13.875,0.09551702814516516
615,26,0,0.0,26,0,87305.39265134318,20.153846153846153,0.11099917697833475
616,13,0,0.0,13,0,0.0,19.153846153846153,0.09917671478850677
617,55,4,0.07272727272727272,51,0,24182.41800221456,14.090909090909092,0.09153090383642595
618,25,2,0.08,23,0,85486.88947314637,16.32,0.1067936805896545
619,13,2,0.15384615384615385,11,0,5.6410256410256405,17.0,0.106263172282076
620,16,0,0.0,16,0,147183.9323108604,20.375,0.12987786865170026
621,15,0,0.0,15,0,18422.835707127826,45.666666666666664,0.12094865879601382
622,11,1,0.09090909090909091,10,0,25363.99568303119,34.54545454545455,0.1350919949280048
623,24,0,0.0,24,0,65335.95197272039,28.125,0.1089484796643107
624,40,1,0.025,39,0,38197.388499934554,50.175,0.09534715929552662
625,28,1,0.03571428571428571,27,0,238779.54343329385,18.142857142857142,0.08846874352940794
626,14,1,0.07142857142857142,13,0,1172.8471373402979,426.5,0.14682249706715042
627,17,1,0.058823529411764705,16,0,43184.71832698731,10.117647058823529,0.09211686542343636
628,15,1,0.06666666666666667,14,0,0.0,9.2,0.08839010174656693
629,30,1,0.03333333333333333,29,0,71512.90523474969,50.2,0.10690053435678307
630,24,4,0.16666666666666666,20,0,0.0,39.583333333333336,0.09272894160680067
631,54,4,0.07407407407407407,50,0,76729.22705991314,17.74074074074074,0.10329394319716233
632,42,3,0.07142857142857142,39,0,385342.07260848087,146.71428571428572,0.1257120357737922
633,16,2,0.125,14,0,14185.168723979414,137.625,0.11599247404756259
634,18,1,0.05555555555555555,17,0,30596.189629598786,455.1666666666667,0.1304027654190688
635,28,0,0.0,28,0,54287.19141476791,14.25,0.11792694511392342
636,19,2,0.10526315789473684,17,0,754.0671762424755,12.052631578947368,0.0961255718283306
637,15,1,0.06666666666666667,14,0,18263.588049746086,19.6,0.11831151780591634
638,11,0,0.0,11,0,0.0,34.18181818181818,0.12722575019982277
639,18,0,0.0,18,0,147.66030938161578,86.16666666666667,0.10238391114545661
640,60,4,0.06666666666666667,56,0,275326.3171749273,16.25,0.10449618227607352
641,14,1,0.07142857142857142,13,0,106739.13112241977,22.214285714285715,0.10680696003715069
642,43,2,0.046511627906976744,41,0,85533.38364135993,13.55813953488372,0.09909565219736627
643,23,1,0.043478260869565216,22,0,29300.139042858304,15.434782608695652,0.10905927297192465
644,17,1,0.058823529411764705,16,0,93489.87526148306,15.117647058823529,0.10981159072567998
645,37,4,0.10810810810810811,33,0,4890.223470876586,28.91891891891892,0.09500458700156282
646,18,0,0.0,18,0,37409.27662207406,22.166666666666668,0.12243572526132354
647,13,0,0.0,13,0,3.2884615384615383,14.615384615384615,0.06374081700108668
648,10,0,0.0,10,0,1578.3548202374327,587.9,0.17405510208100217
649,15,0,0.0,15,0,38816.43077194125,32.86666666666667,0.09474843471892982
650,15,3,0.2,12,0,88712.60061909001,18.266666666666666,0.09208309986318101
651,17,1,0.058823529411764705,16,0,69834.22559872872,17.58823529411765,0.10485959769384806
652,37,3,0.08108108108108109,34,0,1046.2938408220161,141.1891891891892,0.12633779493386338
653,20,3,0.15,17,0,0.011764705882352943,64.35,0.12059737322422948
654,14,0,0.0,14,0,14863.559583705326,32.5,0.08647059803426727
655,18,0,0.0,18,0,164511.67415124323,22.5,0.10884297982085779
656,23,1,0.043478260869565216,22,0,138532.44308341562,132.04347826086956,0.1372253165938908
657,21,0,0.0,21,0,466549.0697835777,71.95238095238095,0.10315718162334452
658,18,2,0.1111111111111111,16,0,67435.10725165403,37.166666666666664,0.11072238433712861
659,15,0,0.0,15,0,514662.00001637934,68.13333333333334,0.12850855141816195
660,23,1,0.043478260869565216,22,0,37532.04462627437,17.47826086956522,0.11276291417833406
661,27,0,0.0,27,0,135265.38174480785,18.703703703703702,0.1082934386650991
662,25,0,0.0,25,0,141155.94645888693,19.12,0.10964822679376379
663,11,0,0.0,11,0,1581.5280324271241,123.0,0.11577795465826902
664,19,0,0.0,19,0,132534.6509815375,86.73684210526316,0.09560435735604589
665,33,1,0.030303030303030304,32,0,57092.37429050932,65.3030303030303,0.09660437635159183
666,23,2,0.08695652173913043,21,0,12715.74339339396,30.91304347826087,0.10059196278750482
667,17,2,0.11764705882352941,15,0,236971.03330934813,226.23529411764707,0.12593884074430753
668,13,1,0.07692307692307693,12,0,63905.05640894248,19.923076923076923,0.10089394755675798
669,25,2,0.08,23,0,61979.8352529083,15.44,0.10289439598516054
670,17,0,0.0,17,0,22990.121848739494,21.705882352941178,0.09950296983259264
671,14,0,0.0,14,0,34936.26270277503,16.285714285714285,0.12374384765079346
672,15,0,0.0,15,0,19202.414821107683,13.0,0.10824163608636346
673,26,1,0.038461538461538464,25,0,173253.07979515116,26.076923076923077,0.10138113583587119
674,25,2,0.08,23,0,93993.40755553941,16.44,0.09259852388102856
675,15,1,0.06666666666666667,14,0,259101.93406275986,243.26666666666668,0.1081235325348441
676,16,3,0.1875,13,0,2.625,29.3125,0.0879127535474536
677,23,1,0.043478260869565216,22,0,71061.7070437623,87.78260869565217,0.12260161889306097
678,19,1,0.05263157894736842,18,0,0.03527397513712882,42.1578947368421,0.12555125933251957
679,11,0,0.0,11,0,3304.8246458330336,117.9090909090909,0.0865937354063835
680,22,2,0.09090909090909091,20,0,120.80729858495837,71.4090909090909,0.1111174441096618
681,15,0,0.0,15,0,0.0,11.466666666666667,0.10818393751254313
682,20,1,0.05,19,0,184650.58917467232,12.2,0.09487822313593622
683,18,4,0.2222222222222222,14,0,46371.59732977796,15.833333333333334,0.07785819237578018
684,22,0,0.0,22,0,1795.1925199302343,22.136363636363637,0.09805660922824756
685,12,0,0.0,12,0,20477.352214778548,19.0,0.08234884595527721
686,11,0,0.0,11,0,615833.6406368562,41.0,0.1193003181838852
687,18,2,0.1111111111111111,16,0,3490.3233810872407,15.61111111111111,0.12060448645966747
688,39,2,0.05128205128205128,37,0,50955.937934301095,52.256410256410255,0.11789289184803946
689,23,2,0.08695652173913043,21,0,2847.457440771224,115.56521739130434,0.07996357630347074
690,32,3,0.09375,29,0,37494.184372819225,50.0,0.09973745065001151
691,51,2,0.0392156862745098,49,0,150156.01031992162,108.94117647058823,0.12254756099954325
692,25,0,0.0,25,0,68769.10347921946,24.72,0.09976051918736895
693,22,0,0.0,22,0,91301.7924253974,25.90909090909091,0.1304615918628415
694,16,1,0.0625,15,0,0.0,84.0,0.10457490769326559
695,23,1,0.043478260869565216,22,0,67849.17993041962,34.52173913043478,0.09447786162570564
696,22,0,0.0,22,0,4334.555150840646,19.272727272727273,0.1235089157007261
697,16,0,0.0,16,0,22900.890300011553,10.9375,0.10339076205188781
698,76,6,0.07894736842105263,70,0,62970.93127642475,49.28947368421053,0.1156741287580152
699,44,5,0.11363636363636363,39,0,38286.41747237663,55.43181818181818,0.12098234007541664
700,20,0,0.0,20,0,11077.552740599112,141.5,0.13592955041902477
701,19,0,0.0,19,0,29279.70607219682,17.789473684210527,0.12544777543256472
702,17,0,0.0,17,0,48945.151601130805,431.0,0.14655736688026288
703,14,0,0.0,14,0,29996.925390822733,280.7857142857143,0.1393197148244594
704,22,2,0.09090909090909091,20,0,10445.296770836763,36.81818181818182,0.09447398173457623
705,14,0,0.0,14,0,28370.038935779234,16.142857142857142,0.08990434772579574
706,25,1,0.04,24,0,4432.189479223787,77.4,0.10704619394940637
707,33,5,0.15151515151515152,28,0,65634.07208963805,131.72727272727272,0.12193418877466553
708,16,1,0.0625,15,0,6098.904609360002,159.9375,0.11052893836076762
709,19,0,0.0,19,0,139.77687204574127,82.3157894736842,0.10083445601116035
710,35,2,0.05714285714285714,33,0,123059.1826994825,18.0,0.10833627395951152
711,14,0,0.0,14,0,56127.79892495385,10.071428571428571,0.08022061682571166
712,12,0,0.0,12,0,4252.401376174731,15.833333333333334,0.1103165804325056
713,24,2,0.08333333333333333,22,0,117372.58125107964,11.875,0.08889405373377478
714,19,0,0.0,19,0,92029.24054204271,17.157894736842106,0.10777132311211035
715,12,1,0.08333333333333333,11,0,0.0558504606337873,27.083333333333332,0.09587132587413842
716,42,2,0.047619047619047616,40,0,301831.39271171833,43.357142857142854,0.10920077543428995
717,18,1,0.05555555555555555,17,0,13717.452879617327,9.166666666666666,0.08926396682932933
718,24,3,0.125,21,0,19748.155731038918,18.75,0.10928923066795597
719,15,2,0.13333333333333333,13,0,1408.8105127905953,13.266666666666667,0.07915885216085462
720,18,2,0.1111111111111111,16,0,135753.9186347488,34.388888888888886,0.11664716744126347
721,14,0,0.0,14,0,633.5137782253712,334.85714285714283,0.13346345200131526
722,23,0,0.0,23,0,149439.68664447474,12.91304347826087,0.08285775872750645
723,17,0,0.0,17,0,73436.5244687123,22.823529411764707,0.12381101067205519
724,11,0,0.0,11,0,158859.31297215587,127.18181818181819,0.14467019622243354
725,24,0,0.0,24,0,84144.62752811318,23.0,0.11916082510062825
726,20,3,0.15,17,0,21611.141243359663,22.9,0.08674197995287247
727,14,1,0.07142857142857142,13,0,189.69718349064888,97.35714285714286,0.10663217436589549
728,14,0,0.0,14,0,82649.04283639393,35.5,0.12376213637652202
729,12,0,0.0,12,0,47513.520435448234,208.75,0.13822221220126246
730,14,2,0.14285714285714285,12,0,0.0,18.428571428571427,0.10766433840205634
731,13,2,0.15384615384615385,11,0,45951.87821081175,800.6153846153846,0.17905896888959638
732,13,4,0.3076923076923077,9,0,9258.769230769232,20.307692307692307,0.11727306107363002
733,30,3,0.1,27,0,16305.644686732687,143.3,0.12896477077258833
734,10,1,0.1,9,0,12036.400000000018,15.3,0.1177468908996937
735,20,0,0.0,20,0,23965.56608624915,112.65,0.11590739783693642
736,16,1,0.0625,15,0,0.0,16.125,0.10766396555133284
737,11,0,0.0,11,0,167948.18916445758,27.454545454545453,0.09782587134303579
738,16,1,0.0625,15,0,2127.6070758008022,23.1875,0.13307981783374978
739,23,1,0.043478260869565216,22,0,134286.85635853655,16.82608695652174,0.10341951853086107
740,12,1,0.08333333333333333,11,0,0.0,27.833333333333332,0.11647333356084061
741,12,2,0.16666666666666666,10,0,0.2222222222222222,66.25,0.12732812516245992
742,14,2,0.14285714285714285,12,0,7585.3634844487515,23.357142857142858,0.129960165292684
743,16,0,0.0,16,0,52307.18130893738,235.25,0.13837974264239059
744,15,0,0.0,15,0,88501.01214799033,16.266666666666666,0.08992328233899244
745,19,1,0.05263157894736842,18,0,22168.63157894737,23.36842105263158,0.09883778473050671
746,18,0,0.0,18,0,3615.83932328059,123.05555555555556,0.10323172004858182
747,27,2,0.07407407407407407,25,0,83668.9061293932,20.14814814814815,0.11267382288213733
748,16,1,0.0625,15,0,30088.0,15.9375,0.1113331325191825
749,25,3,0.12,22,0,43113.4085843267,87.04,0.11182207786493771
750,18,0,0.0,18,0,79941.9572558606,14.833333333333334,0.09026283533426897
751,14,1,0.07142857142857142,13,0,22911.482336939,169.78571428571428,0.12023315026066136
752,11,1,0.09090909090909091,10,0,211436.70403716384,17.363636363636363,0.1159000286062949
753,29,0,0.0,29,0,2075.6595410381096,27.896551724137932,0.10343719146495067
754,17,0,0.0,17,0,73434.11244316823,30.352941176470587,0.08031744336079984
755,13,0,0.0,13,0,52076.59753163234,15.615384615384615,0.10213864544361059
756,23,1,0.043478260869565216,22,0,18486.218879340773,127.43478260869566,0.12211711408355294
757,27,1,0.037037037037037035,26,0,24506.785161225805,15.074074074074074,0.09185821587058901
758,23,0,0.0,23,0,64307.879530244514,11.826086956521738,0.10745954265965295
759,15,0,0.0,15,0,38292.66720923125,83.93333333333334,0.10988872338023874
760,26,2,0.07692307692307693,24,0,210216.63452382895,61.30769230769231,0.13510446289507155
761,45,0,0.0,45,0,606515.6877308349,19.533333333333335,0.12842439271859624
762,26,1,0.038461538461538464,25,0,199218.25929066754,21.96153846153846,0.11957376620775532
763,40,7,0.175,33,0,77478.022601217,56.025,0.09468444536265477
764,17,1,0.058823529411764705,16,0,119698.35841828918,15.882352941176471,0.08386253923428079
765,21,2,0.09523809523809523,19,0,42111.305596143604,22.857142857142858,0.11497069654987872
766,11,4,0.36363636363636365,7,0,31150.667622145942,18.818181818181817,0.07049433626546113
767,14,0,0.0,14,0,28061.638776581553,95.64285714285714,0.10929508386718743
768,35,4,0.11428571428571428,31,0,80953.78044518759,13.942857142857143,0.1035097210841529
769,14,1,0.07142857142857142,13,0,155806.84792348562,15.785714285714286,0.12190041322278168
770,13,1,0.07692307692307693,12,0,174623.63825755107,12.923076923076923,0.09054816854643813
771,22,1,0.045454545454545456,21,0,3015.0179807609015,17.545454545454547,0.07591939422900561
772,26,0,0.0,26,0,15991.996408348301,19.192307692307693,0.09936196926190474
773,21,0,0.0,21,0,235234.53724917074,72.28571428571429,0.12455481369249281
774,12,1,0.08333333333333333,11,0,2713.129192375286,15.166666666666666,0.13046887357024706
775,15,1,0.06666666666666667,14,0,16302.028502961492,29.333333333333332,0.0987852214588759
776,19,1,0.05263157894736842,18,0,60248.02898123321,199.0,0.1155511323140832
777,22,1,0.045454545454545456,21,0,1.2889610389610393,80.4090909090909,0.11485547588781646
778,18,0,0.0,18,0,12237.141057002404,25.0,0.08520701057832729
779,11,0,0.0,11,0,535.9076571594887,298.72727272727275,0.1149506169198673
780,35,7,0.2,28,0,2862.6174869002543,143.97142857142856,0.10891060937980829
781,16,1,0.0625,15,0,4908.040915188731,8.125,0.11387335193412969
782,14,1,0.07142857142857142,13,0,24763.649786876125,19.714285714285715,0.1182609489267203
783,19,1,0.05263157894736842,18,0,0.0,20.789473684210527,0.09515790967465847
784,12,2,0.16666666666666666,10,0,677350.109487998,27.416666666666668,0.11780521535792067
785,24,1,0.041666666666666664,23,0,88360.96422949455,39.333333333333336,0.10450745158138425
786,23,1,0.043478260869565216,22,0,436931.3685051043,25.91304347826087,0.10659205855274095
787,13,1,0.07692307692307693,12,0,66976.34386841294,26.23076923076923,0.08595673931780867
788,12,1,0.08333333333333333,11,0,206645.67840611632,16.75,0.1100097678390843
789,22,3,0.13636363636363635,19,0,35086.13513814008,17.863636363636363,0.12133855412500578
790,22,1,0.045454545454545456,21,0,59709.68852859547,25.545454545454547,0.09819402942577743
791,27,4,0.14814814814814814,23,0,41922.304383454044,116.37037037037037,0.13554491657037995
792,22,0,0.0,22,0,0.0,24.727272727272727,0.09052639538295772
793,19,0,0.0,19,0,97538.04283490867,14.473684210526315,0.10730248201645279
794,16,0,0.0,16,0,0.125,17.9375,0.08539590481220095
795,11,0,0.0,11,0,6832.09356193344,39.45454545454545,0.11923277820648566
796,17,0,0.0,17,0,10620.0,11.352941176470589,0.07716599307565987
797,21,3,0.14285714285714285,18,0,91905.96863074889,64.47619047619048,0.10723403317486342
798,18,1,0.05555555555555555,17,0,34585.8928468112,29.61111111111111,0.12448200098997535
799,13,1,0.07692307692307693,12,0,27834.898053187917,28.615384615384617,0.12340712862300195
800,29,2,0.06896551724137931,27,0,716.5223718634774,141.24137931034483,0.10491961429400573
801,18,1,0.05555555555555555,17,0,56935.03635766117,23.833333333333332,0.09627895881210419
802,16,1,0.0625,15,0,56.369449284246485,93.5,0.10483748205999668
803,13,3,0.23076923076923078,10,0,0.0515542713542652,148.69230769230768,0.13180567936308712
804,11,0,0.0,11,0,90021.71293781743,10.909090909090908,0.12043562461376056
805,19,1,0.05263157894736842,18,0,140084.68938087867,91.47368421052632,0.12747757483302882
806,30,2,0.06666666666666667,28,0,6090.243380194021,18.933333333333334,0.10253014322004302
807,14,1,0.07142857142857142,13,0,64.42222775342455,103.78571428571429,0.12363539400503039
808,33,2,0.06060606060606061,31,0,51687.163566997035,280.7878787878788,0.12179022494367606
809,19,1,0.05263157894736842,18,0,139.77687204574127,74.15789473684211,0.10664343570653506
810,14,0,0.0,14,0,183278.6776161136,17.5,0.09954063554754526
811,17,1,0.058823529411764705,16,0,7601.952523244417,276.3529411764706,0.13505822657320998
812,13,1,0.07692307692307693,12,0,41508.85635525267,162.84615384615384,0.13651418419874986
813,11,1,0.09090909090909091,10,0,0.0,12.727272727272727,0.07419137068896192
814,15,0,0.0,15,0,0.0,48.06666666666667,0.11825546839716412
815,17,1,0.058823529411764705,16,0,33404.016885770565,67.52941176470588,0.13720317942822396
816,11,0,0.0,11,0,46329.58536039328,19.181818181818183,0.10141485127426311
817,17,0,0.0,17,0,226803.19755937764,21.41176470588235,0.12578767529817425
818,21,1,0.047619047619047616,20,0,272811.56947677885,29.238095238095237,0.12969436520789965
819,17,2,0.11764705882352941,15,0,20234.785527008327,19.58823529411765,0.07697295190151211
820,14,2,0.14285714285714285,12,0,20931.787645346376,656.1428571428571,0.17404298069930005
821,13,1,0.07692307692307693,12,0,125417.94372374605,96.3076923076923,0.142067522265285
822,19,2,0.10526315789473684,17,0,7027.160190026002,83.94736842105263,0.11915295544930553
823,29,2,0.06896551724137931,27,0,4289.29975230146,16.275862068965516,0.07623955227963108
824,18,0,0.0,18,0,95335.0435757257,45.22222222222222,0.12585546104205214
825,25,0,0.0,25,0,185009.79723393294,15.72,0.12334929044567071
826,17,1,0.058823529411764705,16,0,302098.03817836824,116.0,0.09808372601038334
827,18,1,0.05555555555555555,17,0,33629.20019876232,11.5,0.0803027879435711
828,12,1,0.08333333333333333,11,0,3707.1368904879637,17.333333333333332,0.08724249559647762
829,32,0,0.0,32,0,43577.877077441604,32.1875,0.1265300903395765
830,12,0,0.0,12,0,0.0558504606337873,108.0,0.08717744436944587
831,20,0,0.0,20,0,215786.7024434867,13.6,0.09646677350234592
832,26,2,0.07692307692307693,24,0,510157.8652390943,16.76923076923077,0.1297587744968124
833,27,2,0.07407407407407407,25,0,78175.3233125451,150.88888888888889,0.11374829090781277
834,19,2,0.10526315789473684,17,0,1291.4623070472014,18.36842105263158,0.08246656978044875
835,23,1,0.043478260869565216,22,0,115.46785082039496,68.8695652173913,0.09445028277368187
836,28,0,0.0,28,0,99163.94810831138,63.214285714285715,0.1041578840931197
837,16,1,0.0625,15,0,94475.85704025037,31.6875,0.10530409236331907
838,13,0,0.0,13,0,795797.9796133818,101.6923076923077,0.1077512069205569
839,13,2,0.15384615384615385,11,0,26554.924038686673,121.0,0.12160594539082277
840,20,2,0.1,18,0,48162.367714688604,47.7,0.09598511741663733
841,78,3,0.038461538461538464,75,0,185610.33716951322,11.564102564102564,0.09103527664793687
842,20,1,0.05,19,0,14776.223136373126,63.65,0.11199714568531158
843,56,3,0.05357142857142857,53,0,4528.622525347444,38.107142857142854,0.1011690079658418
844,20,1,0.05,19,0,52547.47416071604,71.8,0.12561250795073314
845,15,2,0.13333333333333333,13,0,133758.78718926574,178.53333333333333,0.10208632276585759
846,26,1,0.038461538461538464,25,0,1530.010169212983,105.07692307692308,0.10249168913581726
847,18,0,0.0,18,0,190120.64853338827,108.44444444444444,0.1128083422488309
848,26,1,0.038461538461538464,25,0,4629.384615384613,20.76923076923077,0.07117656877016953
849,21,1,0.047619047619047616,20,0,216.65474345864945,175.04761904761904,0.10973007064499349
850,28,0,0.0,28,0,96372.13031670172,22.964285714285715,0.0808208507929925
851,18,2,0.1111111111111111,16,0,50023.06390067151,13.722222222222221,0.08776209070871471
852,14,1,0.07142857142857142,13,0,320573.747841061,186.92857142857142,0.14475940174611032
853,50,2,0.04,48,0,323517.90495640633,19.06,0.12752866000244828
854,17,0,0.0,17,0,4272.106170540662,29.294117647058822,0.08593935962285275
855,29,0,0.0,29,0,204383.82883086064,65.6896551724138,0.12174032560534952
856,67,3,0.04477611940298507,64,0,59001.42070317847,14.08955223880597,0.12443991436543635
857,12,1,0.08333333333333333,11,0,81.0,12.833333333333334,0.11562444207071036
858,12,0,0.0,12,0,850.1704006796517,222.5,0.13950792999680492
859,16,0,0.0,16,0,13509.58951929477,89.9375,0.10918174706973477
860,18,1,0.05555555555555555,17,0,43448.88888888888,24.5,0.11036651846386432
861,15,0,0.0,15,0,205925.85480331283,52.4,0.10307129577392879
862,20,1,0.05,19,0,43605.74434654593,20.3,0.08622795001498881
863,25,1,0.04,24,0,20495.401461988964,58.08,0.10133789653437414
864,26,1,0.038461538461538464,25,0,82676.74011198588,25.076923076923077,0.10066050758267803
865,11,2,0.18181818181818182,9,0,31406.62398472135,16.727272727272727,0.07719489546970207
866,13,1,0.07692307692307693,12,0,16555.111172313816,83.92307692307692,0.09828038186163855
867,13,1,0.07692307692307693,12,0,37903.14257486349,17.53846153846154,0.12127972053074215
868,19,2,0.10526315789473684,17,0,497.40466142537156,190.78947368421052,0.10639240026567073
869,14,1,0.07142857142857142,13,0,351.79542561722644,14.214285714285714,0.07863823330125709
870,28,4,0.14285714285714285,24,0,81514.69848202821,267.92857142857144,0.14016667478530567
871,30,1,0.03333333333333333,29,0,5023.622341950054,18.966666666666665,0.09653752195950101
872,11,1,0.09090909090909091,10,0,4140.617728751615,14.090909090909092,0.10697744506545308
873,20,1,0.05,19,0,25099.297335822543,17.7,0.10849563331176833
874,21,0,0.0,21,0,359088.4821951721,19.238095238095237,0.10464072060616719
875,13,0,0.0,13,0,123955.27989050414,24.923076923076923,0.1091222099545488
876,26,0,0.0,26,0,66847.19756966682,15.461538461538462,0.09394292033717172
877,31,3,0.0967741935483871,28,0,64333.168003330175,12.64516129032258,0.09157753190158134
878,14,2,0.14285714285714285,12,0,176747.801185842,21.214285714285715,0.13029710904401012
879,16,3,0.1875,13,0,539698.8447505594,21.0,0.09888186385545507
880,12,0,0.0,12,0,75.21511617296244,115.33333333333333,0.09015356049260448
881,12,1,0.08333333333333333,11,0,70253.74747852945,13.083333333333334,0.06940822442924187
882,12,0,0.0,12,0,39358.55604145755,38.583333333333336,0.11324459475064365
883,57,3,0.05263157894736842,54,0,221148.04946697797,33.89473684210526,0.10919551680650577
884,16,0,0.0,16,0,283930.3127026756,91.125,0.10823807605131058
885,20,0,0.0,20,0,26137.722913617006,16.45,0.0896660839439394
886,21,3,0.14285714285714285,18,0,274.54068869501634,125.52380952380952,0.11413105468502335
887,37,3,0.08108108108108109,34,0,73910.69124424802,160.21621621621622,0.10653723258310137
888,13,0,0.0,13,0,440154.60664423875,116.6923076923077,0.10963954604025027
889,40,0,0.0,40,0,9205.523112387675,22.475,0.0954842603989856
890,36,1,0.027777777777777776,35,0,249275.3521144583,15.055555555555555,0.10431663028111708
891,26,1,0.038461538461538464,25,0,3667.413436125893,65.3076923076923,0.10760183608209112
892,34,1,0.029411764705882353,33,0,21472.02344816409,24.029411764705884,0.13663876936433572
893,12,1,0.08333333333333333,11,0,265.26455071008075,18.25,0.09745786287566965
894,52,3,0.057692307692307696,49,0,33978.249553714384,74.0,0.11211942201184338
895,18,2,0.1111111111111111,16,0,9427.740786222967,20.444444444444443,0.10528058797555291
896,31,3,0.0967741935483871,28,0,6234.592649280009,77.03225806451613,0.10711459556591645
897,14,0,0.0,14,0,23977.52757251498,12.928571428571429,0.09833078861214906
898,17,2,0.11764705882352941,15,0,92176.42190351065,21.11764705882353,0.1299059392573198
899,29,2,0.06896551724137931,27,0,42280.55164921422,13.206896551724139,0.08973383619909364
900,35,2,0.05714285714285714,33,0,86676.1851139762,80.54285714285714,0.10847884799426705
901,20,1,0.05,19,0,531.1521137738168,255.5,0.122608633801998
902,16,0,0.0,16,0,57439.17783329377,30.5,0.11569785193850293
903,15,1,0.06666666666666667,14,0,0.06666666666666667,10.6,0.098715569109814
904,18,1,0.05555555555555555,17,0,48885.431733368285,38.0,0.12325098900868231
905,26,2,0.07692307692307693,24,0,0.276923076923077,110.03846153846153,0.10502175235267538
906,34,1,0.029411764705882353,33,0,2874.3281603597957,18.5,0.0861697405032141
907,15,2,0.13333333333333333,13,0,220230.98166842025,37.4,0.11349929876174067
908,11,2,0.18181818181818182,9,0,1.4545454545454546,27.545454545454547,0.08184024292716058
909,75,8,0.10666666666666667,67,0,54991.39604161071,46.44,0.11903316422406121
910,41,1,0.024390243902439025,40,0,222783.74738183536,28.634146341463413,0.0980653085238326
911,15,0,0.0,15,0,4012.2666666666646,8.133333333333333,0.0941158990932942
912,17,0,0.0,17,0,25137.65707741561,89.17647058823529,0.09037625423377438
913,11,1,0.09090909090909091,10,0,2436.235516123404,33.09090909090909,0.11462174155880285
914,61,3,0.04918032786885246,58,0,33013.29964179229,59.540983606557376,0.10271599709318686
915,18,0,0.0,18,0,779.4277123362882,325.94444444444446,0.1388998132790647
916,33,5,0.15151515151515152,28,0,15476.862267242708,72.18181818181819,0.1181343811743486
917,18,0,0.0,18,0,1531.3527918563202,199.0,0.10421555767743189
918,16,0,0.0,16,0,101571.04736555414,36.4375,0.11477847986531234
919,25,0,0.0,25,0,42350.46858408707,205.2,0.12620873033774999
920,21,0,0.0,21,0,11967.493895202882,119.42857142857143,0.12007001631863626
921,19,1,0.05263157894736842,18,0,218359.3270192207,24.68421052631579,0.13902526891753722
922,11,0,0.0,11,0,898.1314156047996,18.545454545454547,0.12064446462170864
923,61,0,0.0,61,0,11901.941060170486,124.42622950819673,0.10966184670300921
924,29,1,0.034482758620689655,28,0,41903.662511669165,207.58620689655172,0.13170677066401879
925,19,1,0.05263157894736842,18,0,80738.43660348478,31.157894736842106,0.12249770627475227
926,27,1,0.037037037037037035,26,0,10472.43867802788,25.925925925925927,0.11208900367620007
927,12,1,0.08333333333333333,11,0,54.60457197565929,32.333333333333336,0.09497675749699051
928,14,0,0.0,14,0,24548.114430304024,14.214285714285714,0.08677375751632067
929,11,2,0.18181818181818182,9,0,0.0,11.181818181818182,0.12273784850960058
930,13,1,0.07692307692307693,12,0,743.1891797556619,16.46153846153846,0.09571021582095297
931,14,1,0.07142857142857142,13,0,596265.9254811916,39.0,0.09862531068719647
932,11,0,0.0,11,0,967204.7652295842,22.818181818181817,0.06856749884425661
933,14,0,0.0,14,0,306693.63459073566,15.071428571428571,0.11214704429755033
934,22,2,0.09090909090909091,20,0,88261.1198824706,19.045454545454547,0.10219632176560868
935,13,1,0.07692307692307693,12,0,0.3076923076923077,20.923076923076923,0.11545822395218953
936,17,0,0.0,17,0,712512.0537072812,57.94117647058823,0.1327224416953193
937,22,1,0.045454545454545456,21,0,19146.18181818182,29.136363636363637,0.1286454476991446
938,26,1,0.038461538461538464,25,0,815.3954556640667,54.15384615384615,0.12281230071085561
939,14,1,0.07142857142857142,13,0,210276.5308254317,98.78571428571429,0.09994064564183189
940,19,2,0.10526315789473684,17,0,71841.7101019335,122.3157894736842,0.14242836045259621
941,33,3,0.09090909090909091,30,0,57482.03797856896,12.636363636363637,0.1104343600570508
942,22,2,0.09090909090909091,20,0,365299.91383913194,16.545454545454547,0.1037422791216423
943,19,1,0.05263157894736842,18,0,148503.94507709975,145.6315789473684,0.13910873956303174
944,13,0,0.0,13,0,44130.29427339981,15.76923076923077,0.10856874064131716
945,24,1,0.041666666666666664,23,0,29348.763044355826,86.5,0.11972155790388943
946,78,3,0.038461538461538464,75,0,128341.15060656401,20.794871794871796,0.11114534994652292
947,14,2,0.14285714285714285,12,0,55386.27338843829,43.0,0.10802346373742036
948,16,1,0.0625,15,0,26012.866065945214,29.25,0.12356796279447585
949,19,1,0.05263157894736842,18,0,32141.72936182857,12.578947368421053,0.09667715971636533
950,11,2,0.18181818181818182,9,0,110937.3954270626,18.181818181818183,0.11296742384290467
951,40,2,0.05,38,0,261360.48499866127,23.75,0.11125078344715404
952,23,5,0.21739130434782608,18,0,21839.289070411123,37.95652173913044,0.12518842696961588
953,14,0,0.0,14,0,170834.43373242932,13.214285714285714,0.09860316392192049
954,13,1,0.07692307692307693,12,0,15598.81771327998,8.23076923076923,0.07821998295405011
955,18,2,0.1111111111111111,16,0,1.6880341880341885,21.72222222222222,0.10672654642215235
956,13,1,0.07692307692307693,12,0,255.83389199488823,19.0,0.1350499530132666
957,25,0,0.0,25,0,185251.69059343624,62.2,0.095909364738149
958,43,3,0.06976744186046512,40,0,109790.82724352532,28.488372093023255,0.10348129063677089
959,11,0,0.0,11,0,88924.34194686447,47.36363636363637,0.09903326427492738
960,16,1,0.0625,15,0,331.9700711086355,240.25,0.14583113743429388
961,24,2,0.08333333333333333,22,0,226443.11191389803,302.25,0.14405709291415905
962,13,0,0.0,13,0,0.23076923076923078,12.0,0.10793022519474797
963,17,1,0.058823529411764705,16,0,11584.693251597972,270.11764705882354,0.12729985381764325
964,22,0,0.0,22,0,70472.28181925708,16.818181818181817,0.11202471681991373
965,23,1,0.043478260869565216,22,0,26194.57865430695,93.21739130434783,0.10194650669305917
966,16,0,0.0,16,0,84977.58907232244,165.125,0.09398806757339234
967,13,1,0.07692307692307693,12,0,113644.96888658762,20.153846153846153,0.1284302418928261
968,34,3,0.08823529411764706,31,0,90949.25081386302,150.97058823529412,0.1137564073420515
969,41,2,0.04878048780487805,39,0,120659.07850136142,41.09756097560975,0.0987322016623756
970,18,0,0.0,18,0,0.5555555555555556,19.61111111111111,0.09446596941449965
971,21,2,0.09523809523809523,19,0,63994.138446177036,40.04761904761905,0.11144017427964192
972,18,2,0.1111111111111111,16,0,34474.5046453047,24.11111111111111,0.12118619644830396
973,28,2,0.07142857142857142,26,0,5253.7183265247495,392.42857142857144,0.15170618638036001
974,26,1,0.038461538461538464,25,0,31986.206651839562,25.26923076923077,0.09328797335139782
975,11,0,0.0,11,0,312418.8626956512,130.9090909090909,0.13759729318304736
976,39,1,0.02564102564102564,38,0,14058.61027252024,113.3076923076923,0.10599813364818547
977,21,0,0.0,21,0,96948.9940015454,12.523809523809524,0.08626217270714308
978,25,1,0.04,24,0,94889.25494435467,55.36,0.10752855331772442
979,18,0,0.0,18,0,186975.17634740553,21.61111111111111,0.12215680634333216
980,13,0,0.0,13,0,0.0,18.384615384615383,0.0914982158825439
981,19,2,0.10526315789473684,17,0,2386.4129521397394,30.157894736842106,0.11989060388836735
982,12,0,0.0,12,0,109679.59266518422,21.416666666666668,0.08315708193061087
983,17,1,0.058823529411764705,16,0,8042.134737746782,39.94117647058823,0.11497074479666738
984,16,0,0.0,16,0,712170.58159252,40.9375,0.12376731052093956
985,14,1,0.07142857142857142,13,0,276910.02192517085,27.0,0.14495519636631043
986,21,0,0.0,21,0,10336.166721387366,69.66666666666667,0.10746359242534419
987,17,2,0.11764705882352941,15,0,42894.38790352664,82.17647058823529,0.1298040186288611
988,11,0,0.0,11,0,84600.31197007507,17.545454545454547,0.08400401989313132
989,33,4,0.12121212121212122,29,0,33516.33821407264,17.515151515151516,0.08367096094658907
990,20,2,0.1,18,0,32749.774312465317,15.65,0.10793861733097039
991,63,3,0.047619047619047616,60,0,38646.32830533617,62.26984126984127,0.10377407169707097
992,19,1,0.05263157894736842,18,0,0.0,20.42105263157895,0.09791288574118746
993,11,1,0.09090909090909091,10,0,27966.99392181196,22.545454545454547,0.14048977782222502
994,19,2,0.10526315789473684,17,0,682.9880222455298,201.10526315789474,0.130312795252036
995,91,2,0.02197802197802198,89,0,23615.73105380743,118.16483516483517,0.11150468580493159
996,50,3,0.06,47,0,6397.327477407036,61.92,0.10637048953514056
997,28,1,0.03571428571428571,27,0,94.84859174532444,57.67857142857143,0.12432304915432586
998,19,1,0.05263157894736842,18,0,15626.36863580552,97.73684210526316,0.12332570082084297
999,12,2,0.16666666666666666,10,0,0.0,161.66666666666666,0.10653294579520138
1000,22,2,0.09090909090909091,20,0,69427.25152462932,53.77272727272727,0.13699805299404427
1001,16,0,0.0,16,0,99162.54449906705,19.3125,0.12999399164831882
1002,14,2,0.14285714285714285,12,0,1116.7413675271646,421.7857142857143,0.14519914028015496
1003,19,1,0.05263157894736842,18,0,22899.961916974396,151.78947368421052,0.12492269100714729
1004,11,0,0.0,11,0,0.060927775236858876,111.54545454545455,0.09824458935443942
1005,15,2,0.13333333333333333,13,0,16457.22637178306,16.733333333333334,0.10452072933457446
1006,15,2,0.13333333333333333,13,0,1500.5248535068213,259.4,0.0953225394282134
1007,29,1,0.034482758620689655,28,0,16991.28913529613,9.413793103448276,0.07453191465348899
1008,19,2,0.10526315789473684,17,0,0.0,63.05263157894737,0.09690480813493434
1009,13,1,0.07692307692307693,12,0,5474.580275017786,13.692307692307692,0.09156539623180439
1010,28,4,0.14285714285714285,24,0,57763.3866002311,266.89285714285717,0.12777386335145416
1011,56,5,0.08928571428571429,51,0,172858.80223576515,101.58928571428571,0.11790409302403744
1012,20,0,0.0,20,0,91012.58479076569,28.65,0.12881012416029997
1013,50,3,0.06,47,0,26109.105183214542,100.16,0.11319421275068343
1014,11,1,0.09090909090909091,10,0,0.0,18.90909090909091,0.06960555669085278
1015,20,2,0.1,18,0,303703.84946633794,119.5,0.10830304996524036
1016,16,1,0.0625,15,0,69366.65017858797,18.9375,0.08422480839540003
1017,25,3,0.12,22,0,42270.486504187196,117.24,0.1389799021585513
1018,26,3,0.11538461538461539,23,0,28290.07292418483,56.53846153846154,0.10817349362360598
1019,24,1,0.041666666666666664,23,0,2235.239603959181,172.58333333333334,0.12232246018778327
1020,18,1,0.05555555555555555,17,0,55688.962550410964,144.27777777777777,0.12995009075286967
1021,28,0,0.0,28,0,31521.01488189873,26.178571428571427,0.09874729453524164
1022,52,2,0.038461538461538464,50,0,230425.8281662281,19.692307692307693,0.10884122593008246
1023,12,0,0.0,12,0,287271.00977077277,28.666666666666668,0.09229300418816407
1024,14,1,0.07142857142857142,13,0,25049.605781405233,109.14285714285714,0.1179852537022149
1025,18,0,0.0,18,0,8112.7992262038215,201.27777777777777,0.14526896567813766
1026,16,2,0.125,14,0,101592.14475488875,31.5,0.12998309339919994
1027,12,0,0.0,12,0,442.6267614781807,203.08333333333334,0.12632945220963468
1028,11,0,0.0,11,0,23109.45568789705,22.454545454545453,0.13622532206151358
1029,32,1,0.03125,31,0,149195.89962036768,14.3125,0.10668077602057992
1030,13,1,0.07692307692307693,12,0,744.6747351453687,17.615384615384617,0.07601304945087847
1031,14,1,0.07142857142857142,13,0,63140.272008903674,113.28571428571429,0.0767080000068234
1032,29,2,0.06896551724137931,27,0,15547.763717950189,23.310344827586206,0.10482373775175638
1033,43,5,0.11627906976744186,38,0,2574.9305992524896,117.90697674418605,0.12118216398706244
1034,38,0,0.0,38,0,107712.84361389915,23.605263157894736,0.10193707714140798
1035,19,2,0.10526315789473684,17,0,141.3558194141623,77.94736842105263,0.10992473662231902
1036,14,2,0.14285714285714285,12,0,92614.20604787345,39.714285714285715,0.12339467842470007
1037,22,1,0.045454545454545456,21,0,23.732220425387446,34.22727272727273,0.10238867312787801
1038,24,0,0.0,24,0,56325.424800257235,62.666666666666664,0.09737603776348279
1039,18,1,0.05555555555555555,17,0,74751.98035741929,18.333333333333332,0.10353184118673925
1040,14,0,0.0,14,0,214331.05314637316,24.642857142857142,0.11169341684451783
1041,22,1,0.045454545454545456,21,0,12245.692985505913,24.727272727272727,0.0892192513432558
1042,15,1,0.06666666666666667,14,0,109262.78907272102,16.6,0.09572797410715478
1043,38,2,0.05263157894736842,36,0,48554.328423176914,23.05263157894737,0.11257695776220086
1044,22,1,0.045454545454545456,21,0,335597.3831624633,41.59090909090909,0.119671509053615
1045,13,1,0.07692307692307693,12,0,601.2512689051596,189.15384615384616,0.10509488846700626
1046,12,0,0.0,12,0,442.6267614781807,379.8333333333333,0.12372474075811195
1047,22,1,0.045454545454545456,21,0,155200.79535238384,63.31818181818182,0.09735294247751157
1048,20,0,0.0,20,0,12036.211764705882,30.95,0.11565169634347214
1049,46,2,0.043478260869565216,44,0,425158.58493067865,18.956521739130434,0.1107307325942174
1050,29,0,0.0,29,0,45767.852005611974,61.51724137931034,0.08913078519003886
1051,11,0,0.0,11,0,4282696.895528452,253.0909090909091,0.15369824675869775
1052,16,2,0.125,14,0,355737.6523549145,41.3125,0.12567992826192753
1053,26,1,0.038461538461538464,25,0,49722.09193169856,22.46153846153846,0.10546848396303549
1054,13,4,0.3076923076923077,9,0,40378.46649623168,46.23076923076923,0.11155226311741039
1055,32,0,0.0,32,0,13156.077655339259,166.0625,0.11594414770687517
1056,13,0,0.0,13,0,0.0,16.307692307692307,0.09067790648917452
1057,16,0,0.0,16,0,104828.67503027726,40.75,0.09903276313015727
1058,12,0,0.0,12,0,0.013888888888888888,45.75,0.08194895353658849
1059,13,1,0.07692307692307693,12,0,16330.911700081058,56.46153846153846,0.12023945123865
1060,22,2,0.09090909090909091,20,0,1856.4009182314903,112.86363636363636,0.10072991715858691
1061,12,0,0.0,12,0,0.0,9.083333333333334,0.061141557428896764
1062,13,0,0.0,13,0,0.0,15.153846153846153,0.08158634166584068
1063,12,1,0.08333333333333333,11,0,0.0,18.833333333333332,0.10030009794238397
1064,14,0,0.0,14,0,1579.2711220652805,98.71428571428571,0.13268722587298828
1065,22,2,0.09090909090909091,20,0,321527.5013620913,18.772727272727273,0.11378986562994156
1066,22,0,0.0,22,0,558.5399382517099,170.5,0.10670809568454463
1067,45,0,0.0,45,0,19528.195259291624,122.17777777777778,0.11827642161517857
1068,15,2,0.13333333333333333,13,0,29980.77978053922,28.8,0.1012887868027744
1069,49,3,0.061224489795918366,46,0,228707.29135906353,64.55102040816327,0.10583580836613422
1070,21,1,0.047619047619047616,20,0,126450.98006879094,293.8095238095238,0.15288654589133163
1071,29,2,0.06896551724137931,27,0,152369.46428905538,76.13793103448276,0.11500139204024139
1072,40,4,0.1,36,0,27459.983780904946,21.1,0.09644252426581575
1073,13,0,0.0,13,0,6660.486506596191,15.0,0.10300937833957245
1074,18,1,0.05555555555555555,17,0,93396.04429014503,204.0,0.126347031217314
1075,15,0,0.0,15,0,60401.96375825509,38.46666666666667,0.10697060957069872
1076,16,0,0.0,16,0,30478.99622615025,14.6875,0.1106827727921636
1077,27,0,0.0,27,0,11143.259259259263,15.0,0.0953735760985066
1078,50,1,0.02,49,0,42845.90105195018,38.24,0.0969145473774978
1079,14,0,0.0,14,0,18507.127379307665,13.571428571428571,0.11789609371244304
1080,22,2,0.09090909090909091,20,0,61256.92248170729,273.40909090909093,0.13124409182031677
1081,17,2,0.11764705882352941,15,0,55895.58836943628,22.823529411764707,0.08990435444266694
1082,14,1,0.07142857142857142,13,0,18784.32343485677,14.785714285714286,0.08828637740931125
1083,13,0,0.0,13,0,1877.8731448553967,279.0769230769231,0.11961192771389191
1084,35,4,0.11428571428571428,31,0,429327.13874308765,34.31428571428572,0.11937509068081315
1085,15,2,0.13333333333333333,13,0,108059.58588100859,25.866666666666667,0.10924214778475042
1086,16,0,0.0,16,0,383257.01833397883,115.9375,0.13171877172377444
1087,16,1,0.0625,15,0,7523.570163744719,24.5,0.11241222674406873
1088,12,0,0.0,12,0,485006.60689208336,28.25,0.08531688353577795
1089,38,1,0.02631578947368421,37,0,164668.4810975916,29.710526315789473,0.13178433299159717
1090,18,0,0.0,18,0,22059.54862056131,24.11111111111111,0.11970132218991059
1091,24,2,0.08333333333333333,22,0,12962.69655728904,18.833333333333332,0.11110563380119931
1092,22,0,0.0,22,0,42873.31828070825,36.5,0.12663616997606877
1093,32,2,0.0625,30,0,9247.461022869502,68.25,0.11153580454382472
1094,10,2,0.2,8,0,0.0,19.2,0.07994116575445141
1095,17,2,0.11764705882352941,15,0,34443.00089288217,243.64705882352942,0.12278179933639788
1096,45,4,0.08888888888888889,41,0,14369.356903480102,26.488888888888887,0.11128360505602737
1097,18,1,0.05555555555555555,17,0,14738.180005641234,164.66666666666666,0.11080782362235699
1098,11,0,0.0,11,0,1689699.3278214668,55.63636363636363,0.1284963840127655
1099,12,1,0.08333333333333333,11,0,718636.0806877739,20.75,0.12307102744703159
1100,21,2,0.09523809523809523,19,0,6564.005944846949,14.380952380952381,0.08121455843504975
1101,12,2,0.16666666666666666,10,0,5097.792031824183,12.5,0.10289586922195493
1102,16,1,0.0625,15,0,234530.76177420234,21.9375,0.099059450601269
1103,13,2,0.15384615384615385,11,0,874.918327168008,357.61538461538464,0.12643450438454346
1104,13,0,0.0,13,0,29760.65161323117,29.846153846153847,0.09011088948705732
1105,16,4,0.25,12,0,8407.404029618066,108.625,0.10148874122648334
1106,35,3,0.08571428571428572,32,0,5323.54038147754,139.22857142857143,0.10908523381638069
1107,15,2,0.13333333333333333,13,0,48137.97777777778,23.2,0.09382394663942459
1108,38,3,0.07894736842105263,35,0,12889.999931064292,50.421052631578945,0.10127865835429121
1109,11,0,0.0,11,0,21504.597543145253,17.09090909090909,0.07582283829923846
1110,36,1,0.027777777777777776,35,0,57474.68908773406,278.25,0.11930861588981262
1111,25,3,0.12,22,0,69596.54747013583,24.68,0.11323893392075637
1112,11,1,0.09090909090909091,10,0,7017.5460459958995,33.81818181818182,0.14566849195902706
1113,30,3,0.1,27,0,2390.5895137435027,33.36666666666667,0.11303670010308688
1114,14,1,0.07142857142857142,13,0,24015.078430022288,21.142857142857142,0.11010133870686221
1115,47,3,0.06382978723404255,44,0,12586.601273764012,82.61702127659575,0.1267807259018185
1116,20,3,0.15,17,0,19574.00752348288,26.55,0.1111830044423775
1117,31,1,0.03225806451612903,30,0,48924.35082166367,25.612903225806452,0.11917073962987841
1118,31,3,0.0967741935483871,28,0,55130.896847908334,31.387096774193548,0.08243782386715916
1119,11,1,0.09090909090909091,10,0,28556.575721939324,132.63636363636363,0.12909436591783566
1120,15,0,0.0,15,0,28469.881334027486,15.466666666666667,0.10634616546351819
1121,11,0,0.0,11,0,0.0,121.0,0.09402270419830666
1122,54,1,0.018518518518518517,53,0,101.24021768479808,104.51851851851852,0.12311139696015881
1123,20,0,0.0,20,0,4969.122088733544,75.4,0.11876655400788265
1124,13,1,0.07692307692307693,12,0,72861.37898721188,130.6153846153846,0.14228713004377272
1125,18,1,0.05555555555555555,17,0,3873.5431568204463,88.0,0.12404686377918184
1126,41,1,0.024390243902439025,40,0,56956.59917000118,219.73170731707316,0.13005862349018046
1127,17,1,0.058823529411764705,16,0,138914.88942944232,10.352941176470589,0.09850708961606658
1128,16,3,0.1875,13,0,372.6788467995862,304.1875,0.12184529278893914
1129,14,0,0.0,14,0,0.0,9.5,0.07605951730155644
1130,18,0,0.0,18,0,704.223115564383,25.11111111111111,0.10721472362312925
1131,17,0,0.0,17,0,312.44241986695107,162.2941176470588,0.10127567015456258
1132,41,2,0.04878048780487805,39,0,19704.153083442965,145.09756097560975,0.10250612848937676
1133,13,1,0.07692307692307693,12,0,20056.720789491745,59.61538461538461,0.09015867119751392
1134,14,2,0.14285714285714285,12,0,3855.768029957716,15.0,0.11816928299036453
1135,19,0,0.0,19,0,56990.67327018712,23.894736842105264,0.10250421127518186
1136,17,2,0.11764705882352941,15,0,35789.28552395793,20.352941176470587,0.09733865976837984
1137,20,2,0.1,18,0,1199.8894142996726,94.9,0.12152895796725235
1138,21,0,0.0,21,0,54839.337230084806,184.85714285714286,0.11732710060148761
1139,17,1,0.058823529411764705,16,0,441307.5715090128,57.1764705882353,0.11841886788726666
1140,24,4,0.16666666666666666,20,0,3695.3355722212527,158.5,0.11075631572971167
1141,14,0,0.0,14,0,37411.48878448702,21.285714285714285,0.08966851268515033
1142,10,2,0.2,8,0,19968.08845265255,34.2,0.09829782562804648
1143,11,0,0.0,11,0,18399.699589129417,25.90909090909091,0.09691933799495392
1144,28,3,0.10714285714285714,25,0,13967.773809523807,30.035714285714285,0.09704818805677964
1145,25,2,0.08,23,0,1330.2293974721426,71.08,0.10276858584561502
1146,15,1,0.06666666666666667,14,0,344.0337284598661,248.93333333333334,0.13269768122433512
1147,12,0,0.0,12,0,326407.02563160716,227.41666666666666,0.1260387694324457
1148,24,2,0.08333333333333333,22,0,64231.35177940023,79.83333333333333,0.11547535682881982
1149,25,2,0.08,23,0,32392.099086463197,21.28,0.10491959070870667
1150,19,2,0.10526315789473684,17,0,14815.181384275538,80.63157894736842,0.12067139719054366
1151,23,0,0.0,23,0,463.7186027993599,203.34782608695653,0.1293146432682461
1152,15,1,0.06666666666666667,14,0,819.1919094358412,254.6,0.12179188988074034
1153,26,3,0.11538461538461539,23,0,30968.125903193497,21.423076923076923,0.09926250406185923
1154,17,1,0.058823529411764705,16,0,65694.74572736787,48.1764705882353,0.10338489490468107
1155,29,2,0.06896551724137931,27,0,73733.93875196142,24.379310344827587,0.1137868257706206
1156,11,1,0.09090909090909091,10,0,621.6924980298822,11.181818181818182,0.10025744694731445
1157,30,0,0.0,30,0,159687.87557551393,260.3666666666667,0.1344362245892153
1158,12,0,0.0,12,0,207107.172948221,21.833333333333332,0.10111194696733801
1159,11,1,0.09090909090909091,10,0,80727.46332785307,218.8181818181818,0.12686860692154053
1160,15,0,0.0,15,0,188933.6624162939,24.2,0.11214772190696956
1161,13,0,0.0,13,0,20564.205045264465,14.846153846153847,0.09776571753977595
1162,14,0,0.0,14,0,2278.6476369434226,189.78571428571428,0.13438731008351337
1163,25,4,0.16,21,0,24067.0,66.16,0.10770541075173767
1164,29,2,0.06896551724137931,27,0,7415.099513529312,109.13793103448276,0.12816220209996018
1165,15,0,0.0,15,0,86799.62595417084,23.066666666666666,0.08791748766506383
1166,47,2,0.0425531914893617,45,0,154746.91841119426,87.53191489361703,0.12302111736046713
1167,16,0,0.0,16,0,3764.0416666666665,17.0625,0.0748712292912489
1168,42,2,0.047619047619047616,40,0,52634.41475741555,107.30952380952381,0.1126674473714804
1169,18,2,0.1111111111111111,16,0,268806.2923262498,18.38888888888889,0.11149422163248565
1170,23,1,0.043478260869565216,22,0,32323.67394590883,20.304347826086957,0.10297211512273899
1171,11,0,0.0,11,0,82194.26709735999,14.636363636363637,0.11717036133188972
1172,22,3,0.13636363636363635,19,0,7447.719372113668,12.818181818181818,0.10740901841962486
1173,21,1,0.047619047619047616,20,0,247217.83855495465,26.857142857142858,0.09993385102413731
1174,29,0,0.0,29,0,105726.95849889262,11.89655172413793,0.09667990018086225
1175,14,0,0.0,14,0,23319.826086394143,17.928571428571427,0.11802368319148702
1176,20,1,0.05,19,0,140415.2994706228,178.4,0.1373062062931661
1177,15,0,0.0,15,0,219220.0582203864,180.13333333333333,0.1306027206997221
1178,18,2,0.1111111111111111,16,0,147.54225382606023,100.61111111111111,0.09611485623863819
1179,41,2,0.04878048780487805,39,0,413254.98728514253,146.8048780487805,0.13447599690060286
1180,13,2,0.15384615384615385,11,0,18516.30769230769,99.76923076923077,0.12875373269903106
1181,15,3,0.2,12,0,200129.04274529652,190.26666666666668,0.11339229721831831
1182,33,2,0.06060606060606061,31,0,48967.930169135354,30.0,0.10228733444080593
1183,20,1,0.05,19,0,24746.86197210101,50.95,0.1204467201313141
1184,18,1,0.05555555555555555,17,0,10177.764476048282,79.88888888888889,0.10905154152601211
1185,14,1,0.07142857142857142,13,0,26108.332546249225,437.7857142857143,0.1402909902820527
1186,21,2,0.09523809523809523,19,0,2898.667785630081,34.19047619047619,0.08939839819063686
1187,23,2,0.08695652173913043,21,0,13234.949396925314,178.04347826086956,0.10003457048816741
1188,11,0,0.0,11,0,57.27931946100441,106.27272727272727,0.126936170894471
1189,17,1,0.058823529411764705,16,0,557.7947071172856,14.058823529411764,0.1115941295049821
1190,15,0,0.0,15,0,6261.808814903149,58.333333333333336,0.12198245411523656
1191,13,0,0.0,13,0,4629.538461538461,22.0,0.09869639702251115
1192,18,0,0.0,18,0,5622.014554259342,25.166666666666668,0.10558563388736754
1193,33,0,0.0,33,0,11817.35609205643,100.6969696969697,0.13692110133885635
1194,12,0,0.0,12,0,181142.95213160836,28.833333333333332,0.1153292727545722
1195,12,1,0.08333333333333333,11,0,326283.94615525374,20.5,0.11307863702804488
1196,10,1,0.1,9,0,361054.73783660884,26.7,0.09079879831755068
1197,26,0,0.0,26,0,110608.09574392764,50.69230769230769,0.11053109670771669
1198,11,0,0.0,11,0,0.12185555047371775,140.27272727272728,0.12263796708556302
1199,13,2,0.15384615384615385,11,0,50516.56622589759,25.307692307692307,0.10216780865139044
1200,19,1,0.05263157894736842,18,0,51088.054169620555,10.31578947368421,0.08612084089763511
1201,21,2,0.09523809523809523,19,0,109612.92604625344,31.761904761904763,0.12275643912152157
1202,22,0,0.0,22,0,5783.906742656508,30.727272727272727,0.10066800910230221
1203,21,1,0.047619047619047616,20,0,5123.571951162691,200.0952380952381,0.13016762663778111
1204,18,0,0.0,18,0,23631.935670308743,54.77777777777778,0.11716578544508177
1205,29,1,0.034482758620689655,28,0,14833.831846214318,55.724137931034484,0.09999414261018486
1206,11,2,0.18181818181818182,9,0,10278.83266011585,249.63636363636363,0.1627535349808851
1207,24,0,0.0,24,0,166325.8189967392,15.833333333333334,0.09843966157430255
1208,17,0,0.0,17,0,411751.50650013203,25.529411764705884,0.12629377836971584
1209,11,1,0.09090909090909091,10,0,13619.825508253603,11.454545454545455,0.08871377227812591
1210,35,0,0.0,35,0,14753.722592454375,21.571428571428573,0.09775697906205941
1211,45,1,0.022222222222222223,44,0,678158.0887009702,23.511111111111113,0.11005746855390133
1212,23,1,0.043478260869565216,22,0,10644.485490960387,24.08695652173913,0.10258376704356716
1213,18,0,0.0,18,0,114283.29523585265,119.33333333333333,0.14897799049600216
1214,12,1,0.08333333333333333,11,0,797249.4053438669,21.0,0.11425403554669683
1215,12,2,0.16666666666666666,10,0,17561.536507936504,15.25,0.08683850993549803
1216,36,2,0.05555555555555555,34,0,142245.5486889138,98.36111111111111,0.11300616301980192
1217,15,3,0.2,12,0,7463.195013901601,14.0,0.10337241260335435
1218,19,3,0.15789473684210525,16,0,114223.89970793259,64.84210526315789,0.12658967134539614
1219,11,1,0.09090909090909091,10,0,73517.3334628811,14.0,0.08245215274523335
1220,30,2,0.06666666666666667,28,0,253068.75031808624,18.8,0.09839463080512385
1221,47,2,0.0425531914893617,45,0,34820.76517547707,43.12765957446808,0.10323435040745445
1222,15,1,0.06666666666666667,14,0,252890.10694982606,14.8,0.10079160713953378
1223,25,1,0.04,24,0,180936.0708940186,125.08,0.12892549126952016
1224,22,0,0.0,22,0,77178.82452358502,18.545454545454547,0.10689902463076667
1225,17,0,0.0,17,0,567950.769764176,28.352941176470587,0.12364156250228567
1226,12,2,0.16666666666666666,10,0,7375.741272787265,14.916666666666666,0.11332251962318608
1227,16,0,0.0,16,0,142466.38285297985,19.5625,0.09041465623514636
1228,12,1,0.08333333333333333,11,0,0.0,9.916666666666666,0.08046649170157948
1229,14,1,0.07142857142857142,13,0,15383.69547427574,94.07142857142857,0.13226382685273913
1230,24,1,0.041666666666666664,23,0,40078.82801955357,88.41666666666667,0.09878483521611892
1231,13,1,0.07692307692307693,12,0,202386.14952545014,12.384615384615385,0.11800261082235572
1232,11,0,0.0,11,0,49834.76786246349,117.36363636363636,0.09824284722380398
1233,13,1,0.07692307692307693,12,0,495364.35244125366,64.76923076923077,0.12613866607869081
1234,14,0,0.0,14,0,83660.48200474838,19.857142857142858,0.12926060937015688
1235,12,0,0.0,12,0,5123.994367719827,18.166666666666668,0.10912331567455218
1236,13,1,0.07692307692307693,12,0,4114.381670772171,14.076923076923077,0.09883956008309501
1237,23,4,0.17391304347826086,19,0,167320.80185079697,63.21739130434783,0.10218525591899183
1238,11,0,0.0,11,0,61618.426543217196,20.545454545454547,0.10290720390466263
1239,12,1,0.08333333333333333,11,0,118261.20871342871,34.75,0.12501430490649948
1240,12,1,0.08333333333333333,11,0,108302.28023075557,27.833333333333332,0.1192531691609026
1241,11,1,0.09090909090909091,10,0,18986.953141149002,17.181818181818183,0.11481788876860793
1242,11,1,0.09090909090909091,10,0,213982.42879853462,13.818181818181818,0.08797838972849811
1243,18,1,0.05555555555555555,17,0,323501.31003709056,16.166666666666668,0.10037739364722682
1244,13,0,0.0,13,0,129290.99420812036,116.92307692307692,0.09746241942758062
1245,27,0,0.0,27,0,87734.35086249186,64.88888888888889,0.13050392142158115
1246,26,1,0.038461538461538464,25,0,45831.56983000638,156.07692307692307,0.1376073785703943
1247,15,1,0.06666666666666667,14,0,236888.51980009416,31.666666666666668,0.1344113964312142
1248,14,0,0.0,14,0,27949.618535920454,18.785714285714285,0.08716600071774042
1249,11,0,0.0,11,0,15231.780068287973,16.545454545454547,0.0984258151763754
1250,12,0,0.0,12,0,123480.88719508184,30.75,0.1172565158971402
1251,12,1,0.08333333333333333,11,0,69108.3176429579,42.083333333333336,0.07304736990690654
1252,13,1,0.07692307692307693,12,0,45604.22327734519,34.53846153846154,0.08926487654976975
1253,11,1,0.09090909090909091,10,0,5467.636363636366,14.0,0.086118823710703
1254,11,1,0.09090909090909091,10,0,437270.2869407764,13.636363636363637,0.08844519155876043
1255,12,0,0.0,12,0,7973.1141869038665,18.083333333333332,0.13219922134333054
1256,12,0,0.0,12,0,241490.39231518097,10.5,0.10744547853904031
1257,19,0,0.0,19,0,19371.521420395104,142.21052631578948,0.15133372481342477
1258,11,1,0.09090909090909091,10,0,63659.660937160115,14.727272727272727,0.11934235797659563
1259,11,1,0.09090909090909091,10,0,537348.0030975097,135.8181818181818,0.11161890188270461
1260,18,3,0.16666666666666666,15,0,17549.535004461217,75.11111111111111,0.11278180555092926
1261,19,0,0.0,19,0,86477.19247153272,16.894736842105264,0.12688272309973656
1262,17,1,0.058823529411764705,16,0,9848.336965551114,9.058823529411764,0.09587601967383083
1263,12,0,0.0,12,0,2138.34492673874,51.666666666666664,0.10691567706079734
1264,77,5,0.06493506493506493,72,0,775106.2082480871,22.948051948051948,0.11848478887189175
1265,20,2,0.1,18,0,7234.000005850884,15.05,0.09101742392788924
1266,598,34,0.056856187290969896,564,0,481060.9949934637,25.306020066889634,0.1266779181310339
1267,18,1,0.05555555555555555,17,0,300872.40698316344,14.88888888888889,0.10291990522837617
1268,13,2,0.15384615384615385,11,0,61147.311508229155,10.538461538461538,0.124509819773226
1269,11,0,0.0,11,0,106538.18042366896,9.181818181818182,0.07627675242221045
1270,11,1,0.09090909090909091,10,0,114491.30390507936,22.454545454545453,0.10940075205630394
1271,12,0,0.0,12,0,144751.35032755593,18.166666666666668,0.13040859397564283
1272,17,2,0.11764705882352941,15,0,152135.73425111006,81.88235294117646,0.12253788687177503
1273,12,2,0.16666666666666666,10,0,147641.2839580916,13.833333333333334,0.12504245762372188
1274,13,1,0.07692307692307693,12,0,110575.32485269882,16.46153846153846,0.1507469632173242
1275,11,2,0.18181818181818182,9,0,453492.7267925504,17.09090909090909,0.10426544175319306
1276,14,2,0.14285714285714285,12,0,15010.502460659782,15.714285714285714,0.09485663307346923
1277,12,1,0.08333333333333333,11,0,55351.735450187465,13.25,0.10782410411018574
1278,605,40,0.06611570247933884,565,0,111892.35734261523,26.31900826446281,0.10600208725458264
1279,17,0,0.0,17,0,27623.819752456253,20.88235294117647,0.10972175371985125
1280,13,0,0.0,13,0,97482.92774356433,22.384615384615383,0.13463305424880975
1281,13,2,0.15384615384615385,11,0,57462.81206850739,19.307692307692307,0.09987950930501967
1282,11,0,0.0,11,0,8067.065568536315,12.181818181818182,0.10551484886102407
1283,14,0,0.0,14,0,127974.06575164113,12.142857142857142,0.08062863131696255
1284,15,0,0.0,15,0,142785.44454477064,93.8,0.13661697770218456
1285,65,7,0.1076923076923077,58,0,90740.66902118588,21.0,0.1261557399108348
1286,13,0,0.0,13,0,762617.0949341673,36.53846153846154,0.14046189897744027
1287,1646,68,0.041312272174969626,1578,0,93311.50420777338,22.89611178614824,0.10695390878960155
1288,11,0,0.0,11,0,175468.05197908788,34.63636363636363,0.11817746700329484
1289,37,2,0.05405405405405406,35,0,52954.54104096692,11.864864864864865,0.10189358936941777
1290,161,8,0.049689440993788817,153,0,52629.964131747525,22.25465838509317,0.10624254497683283
1291,11,0,0.0,11,0,0.0,13.454545454545455,0.11124577837300881
1292,71,4,0.056338028169014086,67,0,112309.32171276616,17.295774647887324,0.10682583964196224
1293,17,0,0.0,17,0,8460.113400357526,15.764705882352942,0.12333620064290528
1294,26,2,0.07692307692307693,24,0,126147.87582222465,16.884615384615383,0.12573468447510028
1295,41,3,0.07317073170731707,38,0,177488.73286367886,30.51219512195122,0.11344871271161845
1296,28,1,0.03571428571428571,27,0,39121.54462072036,16.785714285714285,0.10761442916433621
1297,30,2,0.06666666666666667,28,0,15687.206989644928,21.833333333333332,0.1143624236522281
1298,31,2,0.06451612903225806,29,0,6208.718509479061,12.451612903225806,0.10744527874008145
