,total,LMICs,LMICs_perc,HICs,Unknown,Avg BC,Avg DC,Avg CC
0,10937,1842,0.16841912773155343,9095,0,150617.8553717658,21.725884611867972,0.11068313384141115
1,26,3,0.11538461538461539,23,0,79039.48040157264,12.961538461538462,0.11904038630305856
2,16,1,0.0625,15,0,42341.52736940476,14.0,0.09051973969282391
3,63,8,0.12698412698412698,55,0,220359.01240443112,17.063492063492063,0.10907012594326747
4,27,5,0.18518518518518517,22,0,84878.69279937615,20.814814814814813,0.12237285626079862
5,35,4,0.11428571428571428,31,0,322621.72839066107,35.0,0.11957379751384524
6,15,2,0.13333333333333333,13,0,25186.73365165466,16.933333333333334,0.10068722430962344
7,20,5,0.25,15,0,336220.84019838006,17.0,0.10920254343368747
8,35,5,0.14285714285714285,30,0,155305.60603424927,35.82857142857143,0.09961186496621918
9,19,6,0.3157894736842105,13,0,15060.89617249739,11.578947368421053,0.09636704172636033
10,11,1,0.09090909090909091,10,0,25080.4898484841,15.090909090909092,0.11047511073345198
11,23,6,0.2608695652173913,17,0,801510.9309288553,33.34782608695652,0.10888261032017525
12,23,2,0.08695652173913043,21,0,82807.88698331518,15.826086956521738,0.1280707984141769
13,19,3,0.15789473684210525,16,0,299547.0811004206,23.526315789473685,0.1072840562572664
14,35,5,0.14285714285714285,30,0,218484.92659990856,20.714285714285715,0.12042567650945994
15,56,11,0.19642857142857142,45,0,96902.11826216865,21.589285714285715,0.1037743087067465
16,21,4,0.19047619047619047,17,0,73669.24096237366,14.666666666666666,0.09379252467196171
17,12,1,0.08333333333333333,11,0,7733.896502354512,13.583333333333334,0.06906681228244711
18,24,4,0.16666666666666666,20,0,119638.18356787298,16.083333333333332,0.11213572664417037
19,14,3,0.21428571428571427,11,0,152380.4498745287,57.714285714285715,0.1331968263066203
20,13,2,0.15384615384615385,11,0,400775.59845603385,21.846153846153847,0.12360658651363592
21,14,2,0.14285714285714285,12,0,125697.8929942722,15.214285714285714,0.12764656203081992
22,22,4,0.18181818181818182,18,0,127988.57408130377,31.0,0.15178152765977831
23,33,4,0.12121212121212122,29,0,161134.37257246714,17.696969696969695,0.11542082798517389
24,16,5,0.3125,11,0,23790.63806070415,19.8125,0.12598958938670068
25,15,2,0.13333333333333333,13,0,106433.67622946124,25.866666666666667,0.14120266957301641
26,16,4,0.25,12,0,118885.66995232183,21.375,0.1453490341475037
27,22,4,0.18181818181818182,18,0,4546.134575947247,16.59090909090909,0.1108969707310179
28,23,8,0.34782608695652173,15,0,320393.3978193855,40.43478260869565,0.13143313375928592
29,12,1,0.08333333333333333,11,0,73.75493434547262,11.166666666666666,0.13714198536446479
30,29,7,0.2413793103448276,22,0,60680.97432938064,13.89655172413793,0.10501955763893965
31,24,4,0.16666666666666666,20,0,265033.74638597696,22.791666666666668,0.13351806462963753
32,11,2,0.18181818181818182,9,0,104454.80126994192,20.727272727272727,0.15053482151971778
33,13,4,0.3076923076923077,9,0,8746.759613313097,40.53846153846154,0.15482278178037664
34,11,0,0.0,11,0,196576.21233960093,15.090909090909092,0.10704448761093714
35,32,5,0.15625,27,0,144942.15511703142,15.96875,0.12870676104520384
36,18,4,0.2222222222222222,14,0,2953.108626335551,20.27777777777778,0.10936163138455557
37,13,3,0.23076923076923078,10,0,90642.48935620041,18.46153846153846,0.12555690838930497
38,16,2,0.125,14,0,67713.98134893668,16.125,0.09777902291753149
39,32,2,0.0625,30,0,71102.94726332102,11.4375,0.10921705617543459
40,37,8,0.21621621621621623,29,0,160199.2679856398,17.864864864864863,0.13221782766842793
41,25,5,0.2,20,0,3845.2961739766893,22.88,0.09905584831996606
42,14,2,0.14285714285714285,12,0,22487.091336975493,13.214285714285714,0.10828275241371114
43,25,5,0.2,20,0,246434.04481835992,58.16,0.1466856425630516
44,29,5,0.1724137931034483,24,0,71261.15593101952,28.862068965517242,0.1340355046365596
45,22,2,0.09090909090909091,20,0,48489.32628501161,16.0,0.09087602015980328
46,24,4,0.16666666666666666,20,0,160393.3652438422,33.416666666666664,0.12060595073084572
47,16,3,0.1875,13,0,84107.99714580465,18.8125,0.0931987002085588
48,22,6,0.2727272727272727,16,0,57279.6202134462,14.363636363636363,0.11386448772199499
49,22,5,0.22727272727272727,17,0,69100.2809320088,12.954545454545455,0.0915564513433827
50,30,4,0.13333333333333333,26,0,64148.60297003773,21.5,0.12636030150632377
51,46,11,0.2391304347826087,35,0,266077.90328538715,15.173913043478262,0.11145163142329102
52,12,2,0.16666666666666666,10,0,24912.590271238412,14.166666666666666,0.11662963164975644
53,25,6,0.24,19,0,1225790.7484118834,49.64,0.1159332165619282
54,29,6,0.20689655172413793,23,0,18521.70977409334,11.655172413793103,0.0958327407740145
55,29,7,0.2413793103448276,22,0,42627.61476455406,13.827586206896552,0.09845985411617499
56,29,8,0.27586206896551724,21,0,538932.103055705,19.862068965517242,0.12933382990642053
57,28,1,0.03571428571428571,27,0,121693.90398357615,16.214285714285715,0.11744625582876896
58,13,1,0.07692307692307693,12,0,17987.287052209103,16.153846153846153,0.09431474858715612
59,30,5,0.16666666666666666,25,0,100794.64297344846,19.6,0.1085577152458843
60,29,6,0.20689655172413793,23,0,100821.70036836353,20.586206896551722,0.09365135511670722
61,26,9,0.34615384615384615,17,0,119268.5386874905,39.5,0.09337315898324507
62,34,5,0.14705882352941177,29,0,246890.1088593022,20.852941176470587,0.11198990659634166
63,33,4,0.12121212121212122,29,0,119118.73198435978,11.272727272727273,0.08510451675013939
64,11,3,0.2727272727272727,8,0,82426.54058271484,14.090909090909092,0.12103507158735827
65,22,1,0.045454545454545456,21,0,319735.52684328455,49.31818181818182,0.12366052317040807
66,34,4,0.11764705882352941,30,0,86014.85767203991,13.823529411764707,0.1076093150836379
67,13,3,0.23076923076923078,10,0,9799.232531324764,21.76923076923077,0.1207728644053694
68,11,1,0.09090909090909091,10,0,284687.66222917143,19.727272727272727,0.12282096879878952
69,15,0,0.0,15,0,120015.0193897942,13.333333333333334,0.1126858682493831
70,19,1,0.05263157894736842,18,0,4.0127733660645415,13.210526315789474,0.10153488198663521
71,89,16,0.1797752808988764,73,0,299656.21276932827,18.15730337078652,0.1117575794513075
72,20,6,0.3,14,0,309.5597763813643,33.65,0.11398866708586171
73,26,5,0.19230769230769232,21,0,246353.48041253176,32.61538461538461,0.12637528976538628
74,36,11,0.3055555555555556,25,0,52328.37875272923,19.333333333333332,0.11997587467653033
75,20,7,0.35,13,0,19384.287009753032,14.45,0.09474132811564652
76,25,3,0.12,22,0,90768.4747745163,44.8,0.1101822700808309
77,20,7,0.35,13,0,41644.56753481337,14.1,0.11148499209336644
78,44,2,0.045454545454545456,42,0,210916.70742203927,16.727272727272727,0.10657667912516375
79,22,1,0.045454545454545456,21,0,39033.37758689394,14.136363636363637,0.10346052943122186
80,25,5,0.2,20,0,23189.806158156618,13.8,0.1083759054604544
81,31,3,0.0967741935483871,28,0,539880.7349031287,33.03225806451613,0.0879512194431347
82,37,5,0.13513513513513514,32,0,22861.870174658485,25.37837837837838,0.13452719505465818
83,21,3,0.14285714285714285,18,0,147636.68585232357,38.95238095238095,0.10913703667875596
84,28,5,0.17857142857142858,23,0,24895.95191569617,15.035714285714286,0.10003636413771008
85,22,5,0.22727272727272727,17,0,80018.98077590662,38.40909090909091,0.10594766355433306
86,19,2,0.10526315789473684,17,0,122250.95941552341,19.842105263157894,0.1261122721554239
87,12,3,0.25,9,0,29472.118418741,20.0,0.10128232010064504
88,45,8,0.17777777777777778,37,0,358562.8843691477,25.133333333333333,0.11125480598787107
89,23,4,0.17391304347826086,19,0,86815.42165366992,26.347826086956523,0.13045827122326767
90,29,2,0.06896551724137931,27,0,157811.6022357506,10.551724137931034,0.11125797867608472
91,24,5,0.20833333333333334,19,0,163524.68848450462,13.25,0.1056140489370339
92,28,3,0.10714285714285714,25,0,66167.88064361004,11.321428571428571,0.09405172400464946
93,28,4,0.14285714285714285,24,0,237742.2596938302,27.785714285714285,0.10444641922157791
94,23,2,0.08695652173913043,21,0,114759.34050269416,30.782608695652176,0.10213446754555136
95,12,3,0.25,9,0,26526.911978009583,17.0,0.10641148320866282
96,26,6,0.23076923076923078,20,0,10.627566105219696,28.923076923076923,0.12300114049578813
97,22,4,0.18181818181818182,18,0,127423.83039614417,31.727272727272727,0.11620797658359004
98,28,5,0.17857142857142858,23,0,57155.19811459057,19.107142857142858,0.10332815442097132
99,42,1,0.023809523809523808,41,0,6346.872437100887,11.19047619047619,0.10983385215041458
100,19,4,0.21052631578947367,15,0,139372.96514659087,17.63157894736842,0.12609565465291786
101,21,4,0.19047619047619047,17,0,91733.88358843152,12.571428571428571,0.12449619998831875
102,35,6,0.17142857142857143,29,0,1244564.7522007737,37.48571428571429,0.11350134932170877
103,24,4,0.16666666666666666,20,0,37211.77018210607,12.583333333333334,0.1117040480393482
104,17,4,0.23529411764705882,13,0,224488.61675542936,16.11764705882353,0.10900831665241605
105,28,5,0.17857142857142858,23,0,97148.06442232137,23.857142857142858,0.11299939248676107
106,15,2,0.13333333333333333,13,0,10719.970899450007,8.533333333333333,0.11766903198342754
107,25,7,0.28,18,0,121732.8846893276,26.6,0.1335508011165975
108,38,7,0.18421052631578946,31,0,26651.506351690048,22.263157894736842,0.09571216409633532
109,31,6,0.1935483870967742,25,0,40541.696766945504,27.419354838709676,0.11449286726898836
110,34,5,0.14705882352941177,29,0,775050.849789574,24.970588235294116,0.10283913310243407
111,20,6,0.3,14,0,35223.11447035944,28.85,0.0963238797749155
112,22,7,0.3181818181818182,15,0,2177.4460553387266,7.7727272727272725,0.09505381998253205
113,30,8,0.26666666666666666,22,0,200227.08999064265,13.066666666666666,0.10505573824335508
114,16,2,0.125,14,0,92096.33889664391,15.4375,0.10004288340912895
115,20,4,0.2,16,0,58878.054389622805,10.85,0.0818451995756398
116,18,5,0.2777777777777778,13,0,4124.888927204012,40.388888888888886,0.12340364255273932
117,28,3,0.10714285714285714,25,0,243539.51521561985,20.714285714285715,0.12752481650634281
118,28,6,0.21428571428571427,22,0,74410.01006303282,26.642857142857142,0.11546215849934496
119,31,6,0.1935483870967742,25,0,18641.540978455614,11.709677419354838,0.08602517650220447
120,30,6,0.2,24,0,27320.43107176553,10.4,0.09429093819656525
121,20,5,0.25,15,0,265544.94873759546,18.55,0.1324243649524946
122,24,5,0.20833333333333334,19,0,729462.9498313274,27.875,0.1205116921963364
123,35,5,0.14285714285714285,30,0,71907.06018569905,15.285714285714286,0.10278736335083022
124,11,3,0.2727272727272727,8,0,70570.8475360022,18.454545454545453,0.11958628691684646
125,14,1,0.07142857142857142,13,0,33247.87111212781,20.928571428571427,0.11050746289606424
126,26,4,0.15384615384615385,22,0,69996.77466796745,20.153846153846153,0.12128662280585736
127,23,3,0.13043478260869565,20,0,15151.293755001654,12.91304347826087,0.09190700069875604
128,13,0,0.0,13,0,4057.526228905071,10.538461538461538,0.0960425631611583
129,24,4,0.16666666666666666,20,0,194520.61579250335,16.333333333333332,0.10044595358544865
130,43,9,0.20930232558139536,34,0,112295.5650672677,21.302325581395348,0.09383172267320922
131,52,14,0.2692307692307692,38,0,123593.27094473947,18.0,0.10618864489651383
132,19,2,0.10526315789473684,17,0,181942.26150094415,81.42105263157895,0.15021567247626383
133,34,10,0.29411764705882354,24,0,60708.19095628167,13.411764705882353,0.08987982595624616
134,18,0,0.0,18,0,3097.290360381496,15.277777777777779,0.09959121646355493
135,13,4,0.3076923076923077,9,0,143600.03997220236,15.307692307692308,0.10316409013697385
136,19,3,0.15789473684210525,16,0,167030.29318017734,22.736842105263158,0.10961571382116111
137,20,6,0.3,14,0,171774.9918555098,18.5,0.10022834522066429
138,16,0,0.0,16,0,317230.7609507017,34.625,0.14213100819560584
139,15,3,0.2,12,0,93205.67694308603,18.2,0.10795618761883266
140,18,3,0.16666666666666666,15,0,43115.175551599066,15.166666666666666,0.11043367444235853
141,21,4,0.19047619047619047,17,0,32871.0067548774,40.80952380952381,0.1258603764544585
142,19,4,0.21052631578947367,15,0,121505.37924592731,29.210526315789473,0.10661895805999577
143,13,0,0.0,13,0,85746.04209020597,20.923076923076923,0.11881851521843909
144,24,4,0.16666666666666666,20,0,343099.11386516964,16.375,0.10392947192991198
145,38,7,0.18421052631578946,31,0,44560.55083735783,17.342105263157894,0.09615066331079429
146,13,2,0.15384615384615385,11,0,0.0,7.153846153846154,0.06389225670026975
147,12,2,0.16666666666666666,10,0,206153.89499879174,15.75,0.1315987123913799
148,16,3,0.1875,13,0,52167.528472269834,10.4375,0.11595306166121579
149,19,4,0.21052631578947367,15,0,55494.84495156968,18.157894736842106,0.13471945273062505
150,16,2,0.125,14,0,75424.44953252288,11.0625,0.10815503418647296
151,23,1,0.043478260869565216,22,0,92053.71209734544,23.73913043478261,0.11809643277896381
152,19,2,0.10526315789473684,17,0,31689.090308687406,15.578947368421053,0.12642867119033402
153,20,6,0.3,14,0,108257.49165193632,16.15,0.11834452801987767
154,16,3,0.1875,13,0,13227.279564359893,27.75,0.11626176767068122
155,18,1,0.05555555555555555,17,0,105498.41508247254,35.5,0.13512817940653613
156,16,4,0.25,12,0,225760.5430973746,13.3125,0.11149296064419878
157,24,2,0.08333333333333333,22,0,71887.55695630352,10.75,0.11507833881100919
158,13,2,0.15384615384615385,11,0,7040.0,16.615384615384617,0.1100815327822513
159,20,3,0.15,17,0,208410.2759051901,14.75,0.10258408464195361
160,13,2,0.15384615384615385,11,0,31070.904395767,44.61538461538461,0.10730628647425203
161,61,11,0.18032786885245902,50,0,159446.33634969773,22.0327868852459,0.12027200893756917
162,16,1,0.0625,15,0,74945.77645546582,20.0,0.12461840017919279
163,22,5,0.22727272727272727,17,0,48019.985803730364,19.318181818181817,0.11627763554740027
164,30,2,0.06666666666666667,28,0,54179.2661354428,13.4,0.10769538164112322
165,22,7,0.3181818181818182,15,0,237175.75806529121,33.68181818181818,0.12482774460577409
166,23,4,0.17391304347826086,19,0,392008.6843497244,16.73913043478261,0.11235622020838981
167,19,3,0.15789473684210525,16,0,155363.62148551,20.157894736842106,0.12428767921461929
168,33,8,0.24242424242424243,25,0,23423.96762628015,14.727272727272727,0.11013219136210736
169,24,4,0.16666666666666666,20,0,282733.4986105919,11.708333333333334,0.08921066033461363
170,22,2,0.09090909090909091,20,0,70009.52455421758,30.59090909090909,0.13461747313253114
171,13,1,0.07692307692307693,12,0,17117.985863460126,12.76923076923077,0.11380281700633277
172,19,3,0.15789473684210525,16,0,144602.24271660173,15.052631578947368,0.09297054777299736
173,20,4,0.2,16,0,71750.86835324336,14.7,0.12003432821778356
174,15,2,0.13333333333333333,13,0,113970.5795150965,18.8,0.11943999963301265
175,16,1,0.0625,15,0,74114.9519993126,20.75,0.10593864452322097
176,12,2,0.16666666666666666,10,0,5612.09596765327,9.833333333333334,0.09866325769527969
177,12,4,0.3333333333333333,8,0,2.2323917918046727,9.166666666666666,0.10708579827911424
178,16,3,0.1875,13,0,39791.44887169065,15.625,0.1259654873882869
179,14,2,0.14285714285714285,12,0,335540.52184127894,28.857142857142858,0.14889290011284342
180,14,3,0.21428571428571427,11,0,31778.395995268067,35.57142857142857,0.09837202751886952
181,23,2,0.08695652173913043,21,0,331.8814973890727,12.826086956521738,0.0898400563871313
182,13,1,0.07692307692307693,12,0,57683.77727762144,18.307692307692307,0.14096932955730945
183,43,7,0.16279069767441862,36,0,501828.82063965336,31.069767441860463,0.11583744123054414
184,73,9,0.1232876712328767,64,0,58909.841394869945,12.753424657534246,0.10240277307317243
185,12,3,0.25,9,0,82942.23769219469,13.75,0.08671175049987413
186,20,4,0.2,16,0,214261.71165437048,35.2,0.12459946913382074
187,13,2,0.15384615384615385,11,0,0.9230769230769231,15.0,0.0776510416711086
188,19,3,0.15789473684210525,16,0,25032.255531596384,14.210526315789474,0.09871731532391989
189,28,5,0.17857142857142858,23,0,184296.5131606939,11.928571428571429,0.1173696653935553
190,20,4,0.2,16,0,38947.28067586412,10.35,0.12172781949819074
191,19,3,0.15789473684210525,16,0,198656.39970494437,25.105263157894736,0.11963713900511537
192,24,5,0.20833333333333334,19,0,598.6529946818488,14.333333333333334,0.128246886284139
193,28,5,0.17857142857142858,23,0,125515.87208118588,18.0,0.11144383770419226
194,23,3,0.13043478260869565,20,0,39952.55276460452,16.608695652173914,0.09462232523319643
195,22,1,0.045454545454545456,21,0,6863.936166487593,14.863636363636363,0.11547747453032008
196,12,1,0.08333333333333333,11,0,1876180.491740315,37.666666666666664,0.12399458191414821
197,20,4,0.2,16,0,144771.54662454128,12.75,0.09818302244679471
198,25,3,0.12,22,0,132599.65554280198,23.0,0.12320622824480817
199,13,2,0.15384615384615385,11,0,42906.37456243117,19.846153846153847,0.098329492306366
200,41,8,0.1951219512195122,33,0,54210.05298784492,17.463414634146343,0.11106765761037704
201,24,3,0.125,21,0,29083.78252800328,21.583333333333332,0.09733209818552475
202,29,7,0.2413793103448276,22,0,240330.41577777072,19.724137931034484,0.12578333503579772
203,22,5,0.22727272727272727,17,0,44401.13170840401,11.136363636363637,0.09491229696605202
204,30,6,0.2,24,0,288250.8115237517,38.9,0.1051830516754603
205,11,3,0.2727272727272727,8,0,0.0,9.545454545454545,0.0949097864904262
206,28,4,0.14285714285714285,24,0,102484.29380610654,12.785714285714286,0.10732847559480159
207,20,3,0.15,17,0,75650.46563202732,19.25,0.10637793788996933
208,15,5,0.3333333333333333,10,0,116314.05891171364,18.866666666666667,0.1314047719592702
209,16,2,0.125,14,0,165439.6114214766,15.25,0.12291999927984854
210,23,5,0.21739130434782608,18,0,1767.5861602930706,13.869565217391305,0.08897682122591853
211,30,4,0.13333333333333333,26,0,202668.13981628526,17.3,0.12804844974480603
212,17,1,0.058823529411764705,16,0,85125.37248046475,11.882352941176471,0.09962193045593773
213,16,8,0.5,8,0,61487.65184850384,11.5,0.11086000879562063
214,13,2,0.15384615384615385,11,0,120102.33264385219,14.923076923076923,0.12581390937354364
215,44,6,0.13636363636363635,38,0,41514.995602531155,13.681818181818182,0.11439643541593275
216,18,3,0.16666666666666666,15,0,203775.52504994866,45.833333333333336,0.12466445139069468
217,24,7,0.2916666666666667,17,0,6018.391533461962,15.541666666666666,0.11583364910156446
218,25,5,0.2,20,0,101496.41009037747,17.8,0.12487057509665575
219,39,13,0.3333333333333333,26,0,26688.114777411665,14.974358974358974,0.12064975842418398
220,34,4,0.11764705882352941,30,0,9838.344231377378,15.147058823529411,0.1119005326968755
221,12,0,0.0,12,0,22931.92981721958,8.916666666666666,0.13126114243420084
222,41,12,0.2926829268292683,29,0,140928.01152413114,31.341463414634145,0.12974841530006756
223,69,12,0.17391304347826086,57,0,223115.82256581838,17.536231884057973,0.10810144493747915
224,18,2,0.1111111111111111,16,0,415120.8305954716,22.944444444444443,0.1288073862507722
225,24,2,0.08333333333333333,22,0,68810.61558936916,14.5,0.08799807598685987
226,29,8,0.27586206896551724,21,0,454267.08968744794,25.275862068965516,0.12878295498494877
227,14,4,0.2857142857142857,10,0,42884.50619821712,15.857142857142858,0.12048311477575788
228,26,8,0.3076923076923077,18,0,69453.44491558382,27.423076923076923,0.12337132081515856
229,17,2,0.11764705882352941,15,0,670765.8292916563,58.1764705882353,0.12164043660369392
230,22,7,0.3181818181818182,15,0,215530.17680651296,12.5,0.09585332993489398
231,39,8,0.20512820512820512,31,0,162795.18958507452,30.794871794871796,0.12268191815410799
232,19,2,0.10526315789473684,17,0,24786.06756817432,12.947368421052632,0.12154330149232145
233,38,5,0.13157894736842105,33,0,625175.8635907046,26.92105263157895,0.1233226502702585
234,20,3,0.15,17,0,493446.322729153,41.9,0.120691688960699
235,12,2,0.16666666666666666,10,0,30501.33333333334,13.333333333333334,0.10618062871285579
236,17,0,0.0,17,0,31639.11876238169,19.058823529411764,0.11409356989012631
237,40,6,0.15,34,0,53702.1370556559,11.65,0.08051374853611955
238,22,3,0.13636363636363635,19,0,3771.1643458413164,27.863636363636363,0.07569840710209616
239,20,3,0.15,17,0,4151.100195237183,12.15,0.09882470209556822
240,31,4,0.12903225806451613,27,0,61356.241969766364,23.258064516129032,0.11956310087898181
241,13,2,0.15384615384615385,11,0,39497.85001577975,20.923076923076923,0.12919298670637877
242,23,4,0.17391304347826086,19,0,34848.8717617676,20.17391304347826,0.09170595351669211
243,13,2,0.15384615384615385,11,0,9516.869780811427,19.846153846153847,0.0897449065499172
244,24,3,0.125,21,0,269503.30112535815,42.458333333333336,0.13381413783205423
245,15,4,0.26666666666666666,11,0,72734.47150086689,22.6,0.08252803392219236
246,33,5,0.15151515151515152,28,0,147171.8649766936,18.21212121212121,0.12415860667761756
247,27,8,0.2962962962962963,19,0,34007.33486204903,19.962962962962962,0.09502593385523311
248,34,8,0.23529411764705882,26,0,331005.1614277236,25.0,0.11303160030851714
249,20,5,0.25,15,0,40311.702175500395,18.6,0.11983649357483936
250,11,1,0.09090909090909091,10,0,889.7892557104914,11.818181818181818,0.11289972229012989
251,22,6,0.2727272727272727,16,0,171091.48620048954,43.68181818181818,0.13613268349993699
252,26,3,0.11538461538461539,23,0,111233.47813852098,16.807692307692307,0.11936236081829886
253,25,2,0.08,23,0,59466.66452756597,16.72,0.12664651794085524
254,40,7,0.175,33,0,242470.19670874355,23.4,0.11629887310202283
255,15,1,0.06666666666666667,14,0,61018.97388943134,6.533333333333333,0.0887851398337482
256,34,7,0.20588235294117646,27,0,17289.547916046085,24.176470588235293,0.09376148761405859
257,29,5,0.1724137931034483,24,0,30910.75104579092,11.655172413793103,0.10788937143716051
258,23,4,0.17391304347826086,19,0,12781.593442629342,19.91304347826087,0.11759685891209266
259,22,0,0.0,22,0,11701.12063710676,29.045454545454547,0.12899600605697367
260,16,1,0.0625,15,0,130932.38356895259,49.3125,0.132022685516151
261,33,7,0.21212121212121213,26,0,270286.3335745346,17.575757575757574,0.10433458041531969
262,17,2,0.11764705882352941,15,0,92576.85734679784,13.176470588235293,0.07280058250978019
263,16,3,0.1875,13,0,5721.76449329943,28.0,0.07259708336453383
264,11,1,0.09090909090909091,10,0,15219.582814930338,82.27272727272727,0.09887156791352468
265,18,5,0.2777777777777778,13,0,14050.854733649605,13.222222222222221,0.09269852094136186
266,12,0,0.0,12,0,18606.361143058763,11.75,0.09622069616201062
267,36,3,0.08333333333333333,33,0,102612.77144070141,21.13888888888889,0.11183383980713203
268,21,6,0.2857142857142857,15,0,245868.9433493506,17.571428571428573,0.12436913495055857
269,26,5,0.19230769230769232,21,0,463429.856091811,17.73076923076923,0.10936970471277062
270,22,1,0.045454545454545456,21,0,232732.40517009376,37.59090909090909,0.12180424508034195
271,22,5,0.22727272727272727,17,0,1693.1350411217863,27.40909090909091,0.115434452110382
272,15,2,0.13333333333333333,13,0,2605.990209392936,11.533333333333333,0.07377326724776065
273,15,1,0.06666666666666667,14,0,23653.927958568216,13.866666666666667,0.1414553864624337
274,17,3,0.17647058823529413,14,0,16582.26098105771,21.176470588235293,0.11840266064098086
275,14,1,0.07142857142857142,13,0,20.536788791585675,9.642857142857142,0.10683498755042098
276,17,3,0.17647058823529413,14,0,13818.802961126908,33.411764705882355,0.12115272527608228
277,19,6,0.3157894736842105,13,0,0.0,10.0,0.10422939244990992
278,17,4,0.23529411764705882,13,0,34218.38780925078,18.647058823529413,0.1357985895315178
279,22,3,0.13636363636363635,19,0,38081.2563742805,19.363636363636363,0.1207256535397463
280,20,4,0.2,16,0,82504.7346234467,17.2,0.1074174336964614
281,33,3,0.09090909090909091,30,0,28026.23185703309,8.212121212121213,0.08367377764100768
282,31,4,0.12903225806451613,27,0,304550.2117662312,19.64516129032258,0.10606975602678001
283,21,0,0.0,21,0,608557.0743868714,36.285714285714285,0.10910743405475933
284,22,7,0.3181818181818182,15,0,160758.20214673327,14.318181818181818,0.10954809642181788
285,18,2,0.1111111111111111,16,0,81177.99354980857,18.833333333333332,0.10626732571776334
286,23,3,0.13043478260869565,20,0,375955.47728382004,17.52173913043478,0.10082114562832839
287,12,1,0.08333333333333333,11,0,22375.018492759045,53.833333333333336,0.1403796280668738
288,18,3,0.16666666666666666,15,0,556758.0693739408,15.88888888888889,0.11897022820553849
289,23,4,0.17391304347826086,19,0,10045.32472354664,16.73913043478261,0.11400566646701958
290,34,9,0.2647058823529412,25,0,91554.47141677284,17.91176470588235,0.10923247234942389
291,12,2,0.16666666666666666,10,0,11861.957078462743,13.333333333333334,0.09287624834657553
292,17,4,0.23529411764705882,13,0,61569.05568866033,8.235294117647058,0.10591318098950671
293,26,6,0.23076923076923078,20,0,104266.76812234042,16.03846153846154,0.10566282608720509
294,51,9,0.17647058823529413,42,0,105393.49152730318,20.705882352941178,0.12258576361707962
295,18,4,0.2222222222222222,14,0,16442.196779897386,14.722222222222221,0.10194044596464666
296,17,9,0.5294117647058824,8,0,68843.38981754491,60.411764705882355,0.113430832758881
297,24,5,0.20833333333333334,19,0,126029.74067682166,21.833333333333332,0.1373246646091537
298,21,6,0.2857142857142857,15,0,16998.426801423666,15.666666666666666,0.1107389698315121
299,12,2,0.16666666666666666,10,0,111204.70671028174,15.416666666666666,0.12920527662882833
300,18,3,0.16666666666666666,15,0,44236.56990403508,46.333333333333336,0.12886842321930075
301,35,7,0.2,28,0,98911.45518216667,41.885714285714286,0.13274372967816675
302,31,6,0.1935483870967742,25,0,36954.73671334555,18.483870967741936,0.11289042456763236
303,12,3,0.25,9,0,56589.43533811508,17.083333333333332,0.09153151123183058
304,13,0,0.0,13,0,7138.750617558011,12.692307692307692,0.10838835785318304
305,22,4,0.18181818181818182,18,0,259937.82888587614,16.40909090909091,0.09880080623783455
306,16,1,0.0625,15,0,142046.40163481503,16.1875,0.10032669386303102
307,18,0,0.0,18,0,260268.47158564706,19.166666666666668,0.10606326352125817
308,22,4,0.18181818181818182,18,0,337770.6693745501,16.181818181818183,0.09770658529903432
309,23,2,0.08695652173913043,21,0,694341.9865161179,25.26086956521739,0.12362302407436775
310,22,2,0.09090909090909091,20,0,47133.392162718264,12.090909090909092,0.11921513078870576
311,21,5,0.23809523809523808,16,0,137019.13603749388,10.619047619047619,0.05667929926790712
312,15,2,0.13333333333333333,13,0,6101.333333333331,14.4,0.09592539758135596
313,26,4,0.15384615384615385,22,0,1162.6571428719517,20.115384615384617,0.11000159861159584
314,22,4,0.18181818181818182,18,0,174791.34019163586,42.22727272727273,0.11171613104266077
315,15,2,0.13333333333333333,13,0,164474.95044975076,26.4,0.12923097384700033
316,24,6,0.25,18,0,27260.940259701034,10.958333333333334,0.10179430173059911
317,18,3,0.16666666666666666,15,0,119524.42371870468,14.5,0.11814507298660525
318,22,5,0.22727272727272727,17,0,608459.9562317333,25.363636363636363,0.10514907400827221
319,17,3,0.17647058823529413,14,0,124831.36141822525,44.8235294117647,0.1257471898370694
320,38,5,0.13157894736842105,33,0,774102.6368634986,32.23684210526316,0.10967837734784643
321,14,1,0.07142857142857142,13,0,86272.18426095892,44.07142857142857,0.12527157939819805
322,19,3,0.15789473684210525,16,0,63764.62672736628,13.473684210526315,0.1105090198640573
323,13,3,0.23076923076923078,10,0,143969.03426606595,18.384615384615383,0.11797315551843836
324,13,3,0.23076923076923078,10,0,0.0,9.615384615384615,0.09128430603482125
325,25,5,0.2,20,0,471505.74301056436,54.04,0.11766812819572559
326,18,4,0.2222222222222222,14,0,25462.10702434165,12.055555555555555,0.12265615572365772
327,17,3,0.17647058823529413,14,0,57821.1117502086,14.058823529411764,0.11996046415340246
328,24,2,0.08333333333333333,22,0,19987.975262661694,12.041666666666666,0.11373213705240841
329,18,4,0.2222222222222222,14,0,27293.86292800826,13.277777777777779,0.12107693127614673
330,30,4,0.13333333333333333,26,0,123347.98806928082,20.666666666666668,0.1251347566038925
331,14,5,0.35714285714285715,9,0,75880.3836896977,15.214285714285714,0.1137571279262227
332,33,5,0.15151515151515152,28,0,602903.0054282994,21.09090909090909,0.12397654789272397
333,11,1,0.09090909090909091,10,0,0.0,11.545454545454545,0.1295886112010437
334,33,4,0.12121212121212122,29,0,231351.72853264827,31.303030303030305,0.10595095383235738
335,18,5,0.2777777777777778,13,0,16850.950417314696,28.444444444444443,0.11138987162828459
336,41,6,0.14634146341463414,35,0,136735.41469915735,22.658536585365855,0.1136316225212984
337,15,2,0.13333333333333333,13,0,336622.8281978809,20.866666666666667,0.10495721380700482
338,19,5,0.2631578947368421,14,0,201.15299482611337,9.473684210526315,0.1020829122440919
339,17,1,0.058823529411764705,16,0,105459.1465421538,15.294117647058824,0.13931180994234565
340,26,6,0.23076923076923078,20,0,25071.67597649768,12.615384615384615,0.10658650756233931
341,32,8,0.25,24,0,14134.273394885362,11.65625,0.12729559451650027
342,21,3,0.14285714285714285,18,0,63828.23036078898,15.428571428571429,0.13561562932941437
343,16,5,0.3125,11,0,23298.533751307856,14.1875,0.10854453854174143
344,23,3,0.13043478260869565,20,0,46282.53148584887,10.869565217391305,0.11584281859619973
345,24,1,0.041666666666666664,23,0,185753.88722115077,18.625,0.11848504529862265
346,21,5,0.23809523809523808,16,0,41785.29715587109,14.380952380952381,0.11218999257637388
347,24,5,0.20833333333333334,19,0,36418.31700316595,15.5,0.11973622461227185
348,16,2,0.125,14,0,38789.6251008746,14.6875,0.11320738632446681
349,13,1,0.07692307692307693,12,0,7652.947456729418,14.23076923076923,0.1042760094571902
350,15,4,0.26666666666666666,11,0,12626.62799332178,8.2,0.07112528706294617
351,18,5,0.2777777777777778,13,0,25782.401183080205,20.38888888888889,0.08455371453180992
352,22,5,0.22727272727272727,17,0,161185.636235427,15.681818181818182,0.1176107367406397
353,14,2,0.14285714285714285,12,0,976241.1861785565,20.071428571428573,0.13046961306350205
354,28,5,0.17857142857142858,23,0,51950.30312655181,13.821428571428571,0.10871118684874811
355,16,3,0.1875,13,0,827715.248122168,29.0625,0.13569759651861463
356,42,5,0.11904761904761904,37,0,107576.64822624928,29.11904761904762,0.12839649669838116
357,13,1,0.07692307692307693,12,0,12311.302047312463,10.153846153846153,0.08308171558798334
358,29,5,0.1724137931034483,24,0,115803.27723809207,11.0,0.10633479571955916
359,21,2,0.09523809523809523,19,0,51295.74352639126,11.380952380952381,0.1039268249852589
360,16,2,0.125,14,0,30812.59221359024,41.5,0.1382970407598825
361,19,5,0.2631578947368421,14,0,1012977.5649625324,34.10526315789474,0.14716393198398206
362,11,0,0.0,11,0,2.696969696969697,8.0,0.0750784373122977
363,37,8,0.21621621621621623,29,0,418055.3343040528,12.756756756756756,0.11178479169187058
364,15,4,0.26666666666666666,11,0,0.0,8.2,0.0739517863807849
365,25,4,0.16,21,0,269200.97398750717,16.88,0.09577126978664102
366,45,9,0.2,36,0,48898.87270635261,24.555555555555557,0.1068567073414236
367,11,0,0.0,11,0,12002.181702916325,17.181818181818183,0.14993039970860034
368,17,2,0.11764705882352941,15,0,38.51733106686713,17.058823529411764,0.11137411409824445
369,19,4,0.21052631578947367,15,0,99007.01846814902,35.36842105263158,0.1124057890087216
370,11,5,0.45454545454545453,6,0,58315.51552240182,11.363636363636363,0.09770368350653992
371,34,6,0.17647058823529413,28,0,82962.2475389724,16.0,0.10294776366025594
372,14,5,0.35714285714285715,9,0,19293.688592674687,39.142857142857146,0.11905437337695093
373,26,8,0.3076923076923077,18,0,16518.044207487128,13.961538461538462,0.1178717153919905
374,14,0,0.0,14,0,102514.20579594348,12.928571428571429,0.12395162959062088
375,33,10,0.30303030303030304,23,0,262989.539545453,14.909090909090908,0.11892863787877321
376,19,2,0.10526315789473684,17,0,2935.3469530174248,10.842105263157896,0.11463846517697035
377,15,1,0.06666666666666667,14,0,48411.41490864306,17.8,0.1107887041102121
378,13,2,0.15384615384615385,11,0,38302.974504695616,10.846153846153847,0.10897643024146812
379,20,3,0.15,17,0,73541.47244548713,21.65,0.09108038209271219
380,14,2,0.14285714285714285,12,0,458897.5922019711,15.642857142857142,0.12233101262130955
381,22,6,0.2727272727272727,16,0,45451.29117039617,13.772727272727273,0.10257181445056668
382,16,1,0.0625,15,0,5997.428521394705,12.5625,0.078761520579054
383,26,4,0.15384615384615385,22,0,23765.950292954447,61.15384615384615,0.1386904687094073
384,14,3,0.21428571428571427,11,0,67150.82292453568,10.214285714285714,0.09898201223702112
385,12,1,0.08333333333333333,11,0,901987.8839795535,67.33333333333333,0.09828786562755533
386,11,1,0.09090909090909091,10,0,111082.3556430385,31.363636363636363,0.09945093725116803
387,11,0,0.0,11,0,0.5909090909090909,14.363636363636363,0.1043618440495937
388,42,10,0.23809523809523808,32,0,1496992.140261491,37.57142857142857,0.11307536464311886
389,13,1,0.07692307692307693,12,0,467244.9974559494,24.76923076923077,0.12066464175643575
390,38,10,0.2631578947368421,28,0,151605.97313054831,19.710526315789473,0.1030420091260859
391,32,7,0.21875,25,0,105062.2694826092,13.40625,0.11334516025063414
392,19,3,0.15789473684210525,16,0,103245.6465254261,14.947368421052632,0.1073777034126318
393,19,3,0.15789473684210525,16,0,170604.55684275995,18.05263157894737,0.12045489308596062
394,28,4,0.14285714285714285,24,0,6344.84356993002,11.5,0.10838651631547076
395,21,4,0.19047619047619047,17,0,146649.53686378137,19.142857142857142,0.10372823680795504
396,20,2,0.1,18,0,1460514.5864810473,26.65,0.1257547710283184
397,11,3,0.2727272727272727,8,0,56554.3069483252,19.09090909090909,0.11919653003782708
398,16,3,0.1875,13,0,227377.5915391675,21.4375,0.13520541022907423
399,26,5,0.19230769230769232,21,0,702401.2146405305,34.92307692307692,0.11933325295985829
400,19,4,0.21052631578947367,15,0,57063.25527245767,13.68421052631579,0.12118672930758305
401,10,3,0.3,7,0,13728.445454545456,10.6,0.13351479207182188
402,32,7,0.21875,25,0,120685.33938411008,16.5,0.12302743055805349
403,28,3,0.10714285714285714,25,0,85017.93666573228,34.25,0.11465418752864052
404,18,1,0.05555555555555555,17,0,53635.65678276533,8.833333333333334,0.10085330463675986
405,15,2,0.13333333333333333,13,0,231450.1272214244,24.266666666666666,0.1067829520151753
406,14,5,0.35714285714285715,9,0,1172.8877989662062,16.357142857142858,0.08209418456428698
407,21,5,0.23809523809523808,16,0,139897.98202852154,21.333333333333332,0.11843239700031723
408,17,4,0.23529411764705882,13,0,68861.87333894533,15.470588235294118,0.11004192155665754
409,21,4,0.19047619047619047,17,0,191126.38653127995,16.857142857142858,0.08990054377182458
410,17,7,0.4117647058823529,10,0,293941.2182004167,40.529411764705884,0.11850078294065006
411,25,6,0.24,19,0,236280.60826733772,42.52,0.11591696788038386
412,22,4,0.18181818181818182,18,0,187034.28736232687,20.09090909090909,0.14178808886741098
413,11,2,0.18181818181818182,9,0,10598.199000761813,23.363636363636363,0.10644246256883588
414,28,5,0.17857142857142858,23,0,102874.76239553315,15.071428571428571,0.0896870701239012
415,24,6,0.25,18,0,5919.718745877132,12.541666666666666,0.09861061070879035
416,11,3,0.2727272727272727,8,0,17512.870163326606,16.545454545454547,0.10508767473855948
417,34,7,0.20588235294117646,27,0,22714.121982429526,19.029411764705884,0.1164208414071881
418,18,1,0.05555555555555555,17,0,28909.40635201566,25.055555555555557,0.1369683024172466
419,13,3,0.23076923076923078,10,0,6.813259501039975,11.692307692307692,0.09011165895739624
420,21,4,0.19047619047619047,17,0,79959.5511839138,16.095238095238095,0.09297521841431029
421,23,7,0.30434782608695654,16,0,7702.561624428209,34.0,0.1157421449050868
422,18,4,0.2222222222222222,14,0,64518.185526426234,19.833333333333332,0.11224099032712138
423,20,2,0.1,18,0,145685.44593019108,15.65,0.11833764975898964
424,36,8,0.2222222222222222,28,0,57842.14163592076,34.97222222222222,0.11319976623540352
425,18,4,0.2222222222222222,14,0,33056.51000455975,10.666666666666666,0.08436357472934813
426,23,4,0.17391304347826086,19,0,206102.39946054923,17.652173913043477,0.1264794432921855
427,14,1,0.07142857142857142,13,0,138959.77892891256,44.92857142857143,0.13953106136016277
428,12,4,0.3333333333333333,8,0,0.0,13.0,0.10992667659300037
429,18,2,0.1111111111111111,16,0,73872.93575970335,14.944444444444445,0.12427050707333469
430,26,6,0.23076923076923078,20,0,103717.69914204028,15.615384615384615,0.09832833176486198
431,31,6,0.1935483870967742,25,0,175397.8454123626,16.967741935483872,0.10251767805568385
432,28,4,0.14285714285714285,24,0,109224.60390259835,10.464285714285714,0.1011391549672545
433,31,3,0.0967741935483871,28,0,90300.11242663275,10.870967741935484,0.10106818090896726
434,25,5,0.2,20,0,185328.82437303514,17.0,0.09930055523103531
435,18,5,0.2777777777777778,13,0,70926.00553812385,14.61111111111111,0.13647058580009827
436,21,5,0.23809523809523808,16,0,79430.72596622833,14.571428571428571,0.10192747939673633
437,27,7,0.25925925925925924,20,0,82876.93586315108,18.74074074074074,0.11857239212530667
438,16,3,0.1875,13,0,978.1384673093382,17.6875,0.09609435578690695
439,20,3,0.15,17,0,6044.3537511381755,17.85,0.11644078733241647
440,21,3,0.14285714285714285,18,0,35689.98062143508,11.761904761904763,0.09241167406434503
441,20,3,0.15,17,0,158887.745759583,20.1,0.10726872380857817
442,34,4,0.11764705882352941,30,0,21867.274037887968,9.588235294117647,0.11844933970184676
443,22,8,0.36363636363636365,14,0,232274.7981427056,11.681818181818182,0.10941106542219797
444,12,2,0.16666666666666666,10,0,47006.88270320169,14.833333333333334,0.11819233662051225
445,27,5,0.18518518518518517,22,0,1274643.1301759048,91.4074074074074,0.12479299142735004
446,25,5,0.2,20,0,19521.264761894963,16.48,0.12290621625743442
447,19,3,0.15789473684210525,16,0,63508.44739583579,14.263157894736842,0.12786392944255828
448,16,4,0.25,12,0,3520.09223316958,8.625,0.09895374787250427
449,27,3,0.1111111111111111,24,0,63650.772117463435,14.444444444444445,0.11253391737011693
450,17,2,0.11764705882352941,15,0,35447.442525162565,36.23529411764706,0.12724458909027989
451,18,3,0.16666666666666666,15,0,19327.576370804312,54.22222222222222,0.1379658459651405
452,25,8,0.32,17,0,117392.95975346435,13.12,0.0880115441025024
453,14,1,0.07142857142857142,13,0,105549.36148913538,11.142857142857142,0.08679815278430272
454,30,6,0.2,24,0,270947.96919303964,49.0,0.10879397784702588
455,20,3,0.15,17,0,348177.4965772622,38.3,0.12084115731402376
456,18,0,0.0,18,0,16430.166796286194,36.72222222222222,0.11753315489481721
457,13,2,0.15384615384615385,11,0,868.9473019657943,12.692307692307692,0.08714946667838548
458,38,5,0.13157894736842105,33,0,43542.75502897423,17.13157894736842,0.10718876560901906
459,25,1,0.04,24,0,40649.197948864086,12.88,0.10923552873958388
460,25,4,0.16,21,0,54930.0672562162,17.2,0.09144521695475544
461,47,5,0.10638297872340426,42,0,72575.13729311354,18.21276595744681,0.09748671711205271
462,27,10,0.37037037037037035,17,0,87836.66612691153,38.666666666666664,0.12728138888834187
463,12,1,0.08333333333333333,11,0,76222.11012897006,23.5,0.12382016626965076
464,1736,290,0.16705069124423963,1446,0,1567.5268804303757,13.40783410138249,0.10714067804622228
465,13,3,0.23076923076923078,10,0,12628.193376030724,19.46153846153846,0.12306873311282923
466,17,3,0.17647058823529413,14,0,2985.8274792323905,8.764705882352942,0.11912062633932348
467,15,4,0.26666666666666666,11,0,9007.288435969569,12.933333333333334,0.1107840080815716
468,13,3,0.23076923076923078,10,0,197778.35857611417,17.923076923076923,0.11366410566004058
469,18,2,0.1111111111111111,16,0,35713.23896318828,17.22222222222222,0.08842173070309867
470,11,2,0.18181818181818182,9,0,3426.5598979961183,11.181818181818182,0.09022013699055016
471,62,5,0.08064516129032258,57,0,586833.3282683799,33.725806451612904,0.11447902543108689
472,14,3,0.21428571428571427,11,0,6487.066237962077,18.071428571428573,0.12271846621423162
473,17,2,0.11764705882352941,15,0,43368.97793495037,11.058823529411764,0.09001354588866732
474,19,3,0.15789473684210525,16,0,28351.06693112106,11.157894736842104,0.08117603832372401
475,34,6,0.17647058823529413,28,0,125451.0718450902,12.558823529411764,0.11523085957518694
476,53,11,0.20754716981132076,42,0,279927.14716807083,24.849056603773583,0.11568097564020384
477,19,3,0.15789473684210525,16,0,4012.755303006523,9.68421052631579,0.1315942672035113
478,18,5,0.2777777777777778,13,0,13157.828545094884,13.055555555555555,0.12869756192737425
479,20,2,0.1,18,0,804419.3890435053,33.7,0.13836812236966847
480,13,3,0.23076923076923078,10,0,4334.576360332534,41.07692307692308,0.1356341026460253
481,18,2,0.1111111111111111,16,0,149254.59920185345,14.666666666666666,0.12524066903092448
482,21,1,0.047619047619047616,20,0,29203.686088433646,18.571428571428573,0.133356522443176
483,17,2,0.11764705882352941,15,0,9625.935969311317,11.588235294117647,0.11269671550871489
484,13,0,0.0,13,0,68723.53589121545,14.076923076923077,0.13647603950665274
485,17,1,0.058823529411764705,16,0,690341.58440301,21.176470588235293,0.1188347201808073
486,31,3,0.0967741935483871,28,0,247388.0751120662,19.483870967741936,0.10542279218709842
487,12,2,0.16666666666666666,10,0,195887.02366474204,13.583333333333334,0.12346712445206139
488,20,4,0.2,16,0,186206.57563083566,16.45,0.11608682657608109
489,17,5,0.29411764705882354,12,0,14039.821475789817,13.529411764705882,0.11083072362936207
490,32,4,0.125,28,0,258337.07202863527,15.6875,0.12752562216786711
491,19,2,0.10526315789473684,17,0,83413.3563319885,19.842105263157894,0.12584762682734887
492,20,7,0.35,13,0,6268.88700064585,17.85,0.08780920126314658
493,16,4,0.25,12,0,83363.386686849,12.9375,0.11707948074082505
494,14,1,0.07142857142857142,13,0,89788.14630240678,12.928571428571429,0.07581492225900213
495,33,3,0.09090909090909091,30,0,152996.8242790017,14.151515151515152,0.10459490481771186
496,14,1,0.07142857142857142,13,0,1939.3309118078462,15.0,0.09064659363169972
497,23,6,0.2608695652173913,17,0,99207.81391245914,15.217391304347826,0.11646565936655333
498,19,4,0.21052631578947367,15,0,265503.7570812145,15.947368421052632,0.1321032292656794
499,37,10,0.2702702702702703,27,0,50798.870715889316,11.594594594594595,0.11054810428612039
500,21,2,0.09523809523809523,19,0,222000.8886510421,32.333333333333336,0.14302156328153254
501,18,2,0.1111111111111111,16,0,68259.80816572563,23.833333333333332,0.1188195430500445
502,14,3,0.21428571428571427,11,0,198516.95178637624,22.142857142857142,0.13484371380744417
503,16,2,0.125,14,0,1106.6248947983688,14.3125,0.11211863007740495
504,19,2,0.10526315789473684,17,0,8809.93849265183,12.368421052631579,0.0877431598859426
505,19,6,0.3157894736842105,13,0,715061.4672866658,19.894736842105264,0.11191458234139934
506,18,4,0.2222222222222222,14,0,71364.4500948723,8.277777777777779,0.10158346618390451
507,23,3,0.13043478260869565,20,0,33142.781934080864,14.347826086956522,0.10500643644548797
508,12,2,0.16666666666666666,10,0,28940.949189411815,16.166666666666668,0.09535846379738826
509,15,3,0.2,12,0,640514.1355148356,10.266666666666667,0.09779730773241187
510,16,0,0.0,16,0,9202.424024458098,41.875,0.12077695496165058
511,36,9,0.25,27,0,33097.58195746881,38.47222222222222,0.10236174032468044
512,16,1,0.0625,15,0,8304.774427018665,19.875,0.11906934338177802
513,28,4,0.14285714285714285,24,0,134886.15741308584,20.392857142857142,0.12292940480504663
514,32,7,0.21875,25,0,256735.02137789107,21.65625,0.11228248791090696
515,14,4,0.2857142857142857,10,0,272806.8238761264,19.214285714285715,0.13660831511753088
516,14,2,0.14285714285714285,12,0,184212.21799642677,40.07142857142857,0.1233731290728213
517,21,3,0.14285714285714285,18,0,133580.43699551994,19.047619047619047,0.13098977633121733
518,20,3,0.15,17,0,331035.16278590786,47.7,0.11345528496853048
519,22,3,0.13636363636363635,19,0,986958.3789807104,28.363636363636363,0.11747972357756777
520,11,3,0.2727272727272727,8,0,31715.824375388598,11.454545454545455,0.07526871408411988
521,15,3,0.2,12,0,46825.50478967163,17.533333333333335,0.12386251320280303
522,17,3,0.17647058823529413,14,0,4830.4282313751,8.882352941176471,0.09093600980809856
523,35,7,0.2,28,0,105565.13086531479,17.6,0.11884997363504282
524,12,1,0.08333333333333333,11,0,14093.453593934739,17.833333333333332,0.11318965224490507
525,19,4,0.21052631578947367,15,0,160892.83608997156,30.0,0.09915798061412495
526,15,1,0.06666666666666667,14,0,601149.0346147973,63.266666666666666,0.13965358589386628
527,17,3,0.17647058823529413,14,0,434874.39009255124,35.529411764705884,0.15162085142417128
528,12,3,0.25,9,0,93435.94841787005,10.666666666666666,0.07116220324288602
529,24,4,0.16666666666666666,20,0,464799.9619612226,46.833333333333336,0.11918562236132885
530,19,4,0.21052631578947367,15,0,11920.364168709715,22.473684210526315,0.09375074281633164
531,16,1,0.0625,15,0,135855.83064214964,21.3125,0.13434361755597474
532,13,1,0.07692307692307693,12,0,3572.108811631064,10.615384615384615,0.10642479566767629
533,15,0,0.0,15,0,146855.47713056864,23.4,0.12899698499512005
534,11,4,0.36363636363636365,7,0,0.0,16.0,0.11069043657205344
535,39,8,0.20512820512820512,31,0,503780.16007599846,33.76923076923077,0.12605421677233966
536,32,8,0.25,24,0,24190.533821823105,18.09375,0.10892441528133971
537,20,3,0.15,17,0,268130.78507603984,16.45,0.11546973399581037
538,21,1,0.047619047619047616,20,0,203766.86209531178,22.38095238095238,0.10814953493510256
539,18,5,0.2777777777777778,13,0,56509.5753690905,18.77777777777778,0.11519405198026858
540,22,1,0.045454545454545456,21,0,16316.696112133244,14.772727272727273,0.10779322502877026
541,16,2,0.125,14,0,26439.52617123202,19.3125,0.12378276007051078
542,55,10,0.18181818181818182,45,0,194289.10447935204,25.672727272727272,0.11974857028999543
543,26,5,0.19230769230769232,21,0,57847.188864648386,14.76923076923077,0.11483840142068959
544,18,2,0.1111111111111111,16,0,87698.39320958836,12.61111111111111,0.11144746155262585
545,14,4,0.2857142857142857,10,0,121873.18645853647,16.714285714285715,0.08773535507512895
546,14,5,0.35714285714285715,9,0,110948.8031681404,15.428571428571429,0.11964154072958874
547,27,2,0.07407407407407407,25,0,2400.5896873255324,22.703703703703702,0.09149138077932649
548,20,3,0.15,17,0,11371.809874267437,14.0,0.08129574409641056
549,13,3,0.23076923076923078,10,0,7040.0,10.846153846153847,0.11447299929985477
550,26,5,0.19230769230769232,21,0,34080.556535343654,15.692307692307692,0.11007341012687694
551,15,6,0.4,9,0,19171.095117793873,17.866666666666667,0.1282046452018113
552,10,4,0.4,6,0,10916.608234021714,101.3,0.12191070640194283
553,18,3,0.16666666666666666,15,0,52158.65005419924,32.888888888888886,0.09440933512697962
554,12,1,0.08333333333333333,11,0,0.6666666666666666,6.5,0.0700971612041332
555,51,2,0.0392156862745098,49,0,263942.59964759,31.96078431372549,0.11463315364058389
556,14,2,0.14285714285714285,12,0,44845.69985755673,10.928571428571429,0.10267406589111347
557,18,2,0.1111111111111111,16,0,175266.2424369807,20.88888888888889,0.10638975927465608
558,28,5,0.17857142857142858,23,0,104543.81808744473,28.392857142857142,0.10363383832913756
559,24,3,0.125,21,0,33065.1994056849,22.833333333333332,0.11649787221166981
560,24,3,0.125,21,0,49688.53134557389,18.625,0.10724600343602293
561,22,3,0.13636363636363635,19,0,335267.3459099422,22.318181818181817,0.13215264246130873
562,21,9,0.42857142857142855,12,0,33503.39040396209,11.285714285714286,0.11551875074688797
563,11,1,0.09090909090909091,10,0,24483.067390166318,125.18181818181819,0.12577186642922586
564,31,7,0.22580645161290322,24,0,34039.340582109886,11.161290322580646,0.08340267041710817
565,33,9,0.2727272727272727,24,0,147312.6968112912,25.03030303030303,0.1286287964629243
566,36,7,0.19444444444444445,29,0,265881.0288047667,21.833333333333332,0.12361055712723834
567,21,3,0.14285714285714285,18,0,103414.80853501255,12.80952380952381,0.0948046787959077
568,14,5,0.35714285714285715,9,0,11590.29967657496,19.285714285714285,0.09746215937861762
569,25,7,0.28,18,0,75283.04949686983,13.92,0.11738797354408906
570,24,2,0.08333333333333333,22,0,34274.13975055997,14.083333333333334,0.10689629973347392
571,23,4,0.17391304347826086,19,0,39966.258728285145,20.391304347826086,0.12537485028748172
572,23,5,0.21739130434782608,18,0,3922.8780802620954,9.826086956521738,0.11255668684014472
573,14,3,0.21428571428571427,11,0,1053.7232160518781,17.928571428571427,0.12302984153836198
574,19,3,0.15789473684210525,16,0,30270.606572378078,11.157894736842104,0.10068360026266687
575,15,4,0.26666666666666666,11,0,422970.88038128155,11.4,0.08888905218106008
576,24,5,0.20833333333333334,19,0,126688.29063557589,23.25,0.1316884464496841
577,39,7,0.1794871794871795,32,0,128910.69222097576,15.0,0.11439271945974533
578,31,7,0.22580645161290322,24,0,86409.603516025,29.548387096774192,0.10886060555197662
579,19,4,0.21052631578947367,15,0,35846.66604546176,54.10526315789474,0.11996662326931089
580,17,3,0.17647058823529413,14,0,64977.875411782334,26.705882352941178,0.1472237389885795
581,21,6,0.2857142857142857,15,0,659180.5560687422,19.952380952380953,0.14625074166013827
582,17,5,0.29411764705882354,12,0,110929.73720858005,14.764705882352942,0.11119223780118441
583,22,5,0.22727272727272727,17,0,114250.72963172235,28.181818181818183,0.11265801943845827
584,19,4,0.21052631578947367,15,0,61693.48095973314,22.473684210526315,0.12649500195963512
585,16,1,0.0625,15,0,22472.56098781682,11.8125,0.1134082855010237
586,12,2,0.16666666666666666,10,0,803945.3910671565,19.25,0.11073082569768423
587,21,1,0.047619047619047616,20,0,198537.41847042128,26.571428571428573,0.12985870533028562
588,24,8,0.3333333333333333,16,0,12067.480083722636,14.125,0.10800536997023742
589,28,6,0.21428571428571427,22,0,93572.76625388538,18.571428571428573,0.13404049288658246
590,20,3,0.15,17,0,76406.84603269915,16.7,0.13313312475302927
591,23,4,0.17391304347826086,19,0,143478.87987552147,17.47826086956522,0.11467691730222147
592,18,3,0.16666666666666666,15,0,39893.029683748406,14.055555555555555,0.11583454683104584
593,20,2,0.1,18,0,56301.46952992289,14.25,0.10080933399795677
594,13,4,0.3076923076923077,9,0,167056.92595926367,14.923076923076923,0.10829661637625446
595,22,0,0.0,22,0,58394.217725438226,17.59090909090909,0.11297773044192998
596,27,2,0.07407407407407407,25,0,256991.97009804376,20.925925925925927,0.09955526448672722
597,16,2,0.125,14,0,6580.468159485603,8.25,0.09208798518135337
598,21,2,0.09523809523809523,19,0,113913.7844123301,13.428571428571429,0.12295460317633797
599,24,3,0.125,21,0,51609.89273252562,11.958333333333334,0.10679031154364615
600,17,3,0.17647058823529413,14,0,12475.512979397234,6.764705882352941,0.09034223052592874
601,20,3,0.15,17,0,64489.53732852496,11.25,0.08748289100437469
602,32,8,0.25,24,0,10639.450409991054,14.78125,0.12206486472864025
603,20,1,0.05,19,0,52987.47251372391,15.95,0.113310581123373
604,32,1,0.03125,31,0,140859.28939520463,26.65625,0.12207158785235718
605,28,4,0.14285714285714285,24,0,157053.72323298224,14.571428571428571,0.08532909729332105
606,18,5,0.2777777777777778,13,0,261235.97369217552,18.944444444444443,0.11735703532657313
607,20,4,0.2,16,0,69159.16327172352,17.95,0.13086513554775753
608,16,3,0.1875,13,0,142816.38897285683,38.6875,0.11617542864083669
609,18,1,0.05555555555555555,17,0,38597.20632334575,15.833333333333334,0.11385670214928517
610,19,4,0.21052631578947367,15,0,26598.252071312123,27.736842105263158,0.10683112838121374
611,26,9,0.34615384615384615,17,0,308201.7328133549,22.692307692307693,0.10447753612104033
612,15,1,0.06666666666666667,14,0,398575.1131767201,21.8,0.12117657002439011
613,27,4,0.14814814814814814,23,0,121578.82872272741,11.592592592592593,0.0791964793911823
614,33,3,0.09090909090909091,30,0,43677.44703643956,16.424242424242426,0.11788580012334227
615,28,3,0.10714285714285714,25,0,448171.01908393914,19.678571428571427,0.12260751180505591
616,17,5,0.29411764705882354,12,0,259456.77875624155,10.470588235294118,0.09250635095075463
617,29,6,0.20689655172413793,23,0,24099.53261798258,29.96551724137931,0.12432196572251325
618,18,4,0.2222222222222222,14,0,20025.06589176475,11.11111111111111,0.112055330271039
619,15,2,0.13333333333333333,13,0,51919.49008173857,20.6,0.10665183112166592
620,14,3,0.21428571428571427,11,0,129657.57877866396,38.92857142857143,0.10563675612202861
621,23,4,0.17391304347826086,19,0,339829.46048036544,21.434782608695652,0.11264322543842362
622,14,3,0.21428571428571427,11,0,0.0,13.571428571428571,0.10028002174868385
623,17,2,0.11764705882352941,15,0,325957.3649722119,37.88235294117647,0.1262387501122468
624,28,4,0.14285714285714285,24,0,33392.22841806297,14.5,0.10749016986485996
625,18,6,0.3333333333333333,12,0,13798.790890266311,12.777777777777779,0.11110739798457334
626,15,3,0.2,12,0,13809.235204135046,15.666666666666666,0.11040081424748706
627,10,2,0.2,8,0,10759.174178120928,9.1,0.11269800458622874
628,20,4,0.2,16,0,17108.068983390796,8.85,0.08697108932810238
629,26,3,0.11538461538461539,23,0,158806.3725239633,19.846153846153847,0.12053130128085353
630,12,1,0.08333333333333333,11,0,200979.40858110553,9.916666666666666,0.08469834399391425
631,18,1,0.05555555555555555,17,0,153470.37992681414,12.444444444444445,0.11862527943734956
632,23,3,0.13043478260869565,20,0,185627.62865307272,20.652173913043477,0.1286650468369175
633,19,1,0.05263157894736842,18,0,546.0081845250422,9.842105263157896,0.10410202842715201
634,12,2,0.16666666666666666,10,0,174604.05256780158,12.0,0.10333320833185823
635,28,6,0.21428571428571427,22,0,192105.2522697633,14.678571428571429,0.0932984369810431
636,36,4,0.1111111111111111,32,0,750365.7221633239,26.0,0.11017633004350713
637,16,2,0.125,14,0,33151.91956795881,18.4375,0.10958919922176066
638,12,1,0.08333333333333333,11,0,0.0,9.25,0.08099382126744036
639,17,2,0.11764705882352941,15,0,9325.720459873579,14.941176470588236,0.11936554563118434
640,35,2,0.05714285714285714,33,0,511528.0372073959,36.97142857142857,0.11972353602117831
641,23,2,0.08695652173913043,21,0,72968.23950494835,21.652173913043477,0.09020659342918604
642,22,4,0.18181818181818182,18,0,83189.63962773803,15.045454545454545,0.11999998131776703
643,28,4,0.14285714285714285,24,0,101890.47690960481,16.214285714285715,0.10114335097547504
644,11,2,0.18181818181818182,9,0,8566.839564436941,10.363636363636363,0.13059149902882858
645,16,2,0.125,14,0,34140.23528347548,18.875,0.12909850460080866
646,14,2,0.14285714285714285,12,0,8904.568572082708,12.571428571428571,0.0966881624221093
647,11,0,0.0,11,0,79518.80488775716,15.454545454545455,0.0975054495953729
648,13,3,0.23076923076923078,10,0,140875.38854261002,11.923076923076923,0.0985862248358386
649,38,9,0.23684210526315788,29,0,201163.39318542194,26.473684210526315,0.11047944027747429
650,21,4,0.19047619047619047,17,0,63057.004972507035,14.619047619047619,0.12507725235423564
651,21,2,0.09523809523809523,19,0,119479.59670862048,17.571428571428573,0.12759493835014324
652,11,1,0.09090909090909091,10,0,5683.400996452706,53.09090909090909,0.10378623592310333
653,34,4,0.11764705882352941,30,0,223476.14697506346,16.852941176470587,0.09355004250292659
654,16,3,0.1875,13,0,4321.303534950559,12.4375,0.10096078398108407
655,31,6,0.1935483870967742,25,0,126772.13684115831,22.0,0.10531138232363392
656,19,3,0.15789473684210525,16,0,63361.02415322495,13.368421052631579,0.08315032425068197
657,18,3,0.16666666666666666,15,0,98711.22282355026,21.38888888888889,0.1287398898645058
658,15,3,0.2,12,0,166478.03028415266,18.333333333333332,0.10555115321876686
659,12,1,0.08333333333333333,11,0,10800.436045165441,15.25,0.12314794179316536
660,31,4,0.12903225806451613,27,0,78106.03202826761,13.774193548387096,0.11792684314917219
661,12,1,0.08333333333333333,11,0,41997.12166419284,14.5,0.09076932736079668
662,19,5,0.2631578947368421,14,0,381615.15744440333,35.89473684210526,0.138570967354478
663,24,5,0.20833333333333334,19,0,223019.23747366117,17.458333333333332,0.10908947346087229
664,24,2,0.08333333333333333,22,0,157147.71472405104,19.166666666666668,0.12431110543415165
665,20,6,0.3,14,0,35174.820592934826,17.6,0.11864385693176008
666,17,3,0.17647058823529413,14,0,34572.16096258125,17.058823529411764,0.11601306006855357
667,17,3,0.17647058823529413,14,0,384984.7084259205,40.88235294117647,0.1130615576678714
668,12,1,0.08333333333333333,11,0,0.0,20.583333333333332,0.1327090841861862
669,19,1,0.05263157894736842,18,0,8342.883353330486,13.789473684210526,0.09794262580896672
670,28,8,0.2857142857142857,20,0,11694.118617769736,13.392857142857142,0.11179229949782735
671,14,2,0.14285714285714285,12,0,16038.420244140465,21.785714285714285,0.08561340689565215
672,18,1,0.05555555555555555,17,0,950627.1593356846,20.444444444444443,0.11060596657084688
673,26,5,0.19230769230769232,21,0,196865.8419222106,8.961538461538462,0.10846414033462093
674,20,1,0.05,19,0,1027.7615098228384,12.45,0.10194320427710861
675,16,5,0.3125,11,0,147205.5949591816,12.8125,0.11982068395280412
676,15,4,0.26666666666666666,11,0,111463.03195257222,21.866666666666667,0.11926198311177075
677,18,5,0.2777777777777778,13,0,101638.20540904805,24.0,0.13131367219438592
678,37,6,0.16216216216216217,31,0,51062.59636413709,20.83783783783784,0.10698168350088486
679,28,7,0.25,21,0,11076.160149396368,18.785714285714285,0.1157122573712657
680,19,6,0.3157894736842105,13,0,111311.2388567325,12.789473684210526,0.0914673846874638
681,11,1,0.09090909090909091,10,0,66549.81818181818,15.272727272727273,0.12243138712874645
682,26,4,0.15384615384615385,22,0,56623.804666362186,14.461538461538462,0.08968290166216256
683,15,3,0.2,12,0,1275416.8910938269,61.86666666666667,0.09810048065801368
684,26,2,0.07692307692307693,24,0,144362.78131467022,13.807692307692308,0.10248416483219427
685,13,2,0.15384615384615385,11,0,134.72796163727742,10.923076923076923,0.07604701547325898
686,29,8,0.27586206896551724,21,0,95926.95396325331,20.17241379310345,0.11818001681233908
687,16,5,0.3125,11,0,87562.05534944107,17.0,0.11660948011959349
688,17,4,0.23529411764705882,13,0,9831.44867993372,20.0,0.10812769582405529
689,15,1,0.06666666666666667,14,0,15588.411916983654,29.2,0.09482613648414871
690,36,7,0.19444444444444445,29,0,163531.25574758535,14.583333333333334,0.12016142861043945
691,25,7,0.28,18,0,3978.302475773151,12.04,0.10864850683821996
692,15,4,0.26666666666666666,11,0,37745.31191292431,22.266666666666666,0.0979330203893864
693,23,6,0.2608695652173913,17,0,25543.32982474942,15.173913043478262,0.12392182913597388
694,18,2,0.1111111111111111,16,0,65046.60722895961,15.555555555555555,0.1204703250106487
695,15,2,0.13333333333333333,13,0,106357.32887595138,20.8,0.12322586621985492
696,12,1,0.08333333333333333,11,0,0.0,25.75,0.09874611289580942
697,21,3,0.14285714285714285,18,0,100108.61613776992,15.952380952380953,0.11807731533104009
698,17,5,0.29411764705882354,12,0,367450.877621396,14.117647058823529,0.08552326878805787
699,16,4,0.25,12,0,220451.24046351764,17.0,0.1492670172434954
700,30,9,0.3,21,0,178879.22417973273,29.733333333333334,0.14182526967586281
701,20,0,0.0,20,0,385354.43606236705,21.05,0.12028311326509558
702,26,4,0.15384615384615385,22,0,98025.18379847915,13.538461538461538,0.1078820447984352
703,13,4,0.3076923076923077,9,0,89539.17561703737,15.692307692307692,0.12228389400868703
704,35,9,0.2571428571428571,26,0,324675.494332284,16.62857142857143,0.11178175393765327
705,14,0,0.0,14,0,9246.527180913185,18.571428571428573,0.1000944612434372
706,15,1,0.06666666666666667,14,0,9473.747464156117,10.866666666666667,0.08870168346069203
707,16,3,0.1875,13,0,171468.10898140253,19.9375,0.09601013693804412
708,34,11,0.3235294117647059,23,0,25579.35632343202,26.5,0.12717027338420972
709,11,4,0.36363636363636365,7,0,12286.404490682744,11.181818181818182,0.12279385989061611
710,13,1,0.07692307692307693,12,0,16258.386027462635,12.615384615384615,0.08976867314188253
711,14,1,0.07142857142857142,13,0,22891.023458061274,12.714285714285714,0.08411457162669045
712,14,3,0.21428571428571427,11,0,13815.06396701113,15.285714285714286,0.1257254237694156
713,21,4,0.19047619047619047,17,0,77976.77574762328,15.571428571428571,0.11031237204900361
714,20,5,0.25,15,0,265074.2649921727,30.05,0.12984729719423732
715,18,4,0.2222222222222222,14,0,595289.3869872104,22.0,0.11941150242663115
716,23,2,0.08695652173913043,21,0,754542.0707520043,19.304347826086957,0.09930429672586077
717,13,1,0.07692307692307693,12,0,18811.443059617075,39.61538461538461,0.1275548709581606
718,14,2,0.14285714285714285,12,0,57889.46972458258,41.0,0.11067260587855245
719,21,2,0.09523809523809523,19,0,81450.76034617524,13.380952380952381,0.1232920693962105
720,19,4,0.21052631578947367,15,0,373965.89478792594,19.894736842105264,0.11899079142912405
721,21,6,0.2857142857142857,15,0,35113.62718932195,7.571428571428571,0.09967952871685061
722,64,20,0.3125,44,0,225875.91518058674,16.34375,0.09615945643935882
723,31,6,0.1935483870967742,25,0,240554.81727069098,25.0,0.12127663045102802
724,28,8,0.2857142857142857,20,0,69531.18937695339,17.785714285714285,0.10076791217238426
725,19,4,0.21052631578947367,15,0,37605.466188322425,19.63157894736842,0.10873536389758633
726,32,4,0.125,28,0,10980.830377252818,10.65625,0.11200596761353487
727,13,3,0.23076923076923078,10,0,1443.3034763876256,26.307692307692307,0.12127417537494964
728,24,3,0.125,21,0,248140.45560198187,19.25,0.13111873293553408
729,22,6,0.2727272727272727,16,0,81087.85509176302,18.318181818181817,0.11532796133909563
730,27,6,0.2222222222222222,21,0,81464.92469393402,37.96296296296296,0.10485078099382726
731,16,2,0.125,14,0,83244.29011430443,12.375,0.13468475913618452
732,19,1,0.05263157894736842,18,0,26057.605517198663,17.31578947368421,0.10531608533751506
733,16,6,0.375,10,0,52327.00567855292,15.125,0.09175210558798762
734,12,4,0.3333333333333333,8,0,436547.6702302753,64.41666666666667,0.14663035865449484
735,33,5,0.15151515151515152,28,0,35831.49698616013,16.424242424242426,0.11380051108105543
736,15,3,0.2,12,0,128944.3156683839,21.133333333333333,0.12917942895228865
737,21,4,0.19047619047619047,17,0,10359.526395136576,24.904761904761905,0.11245859899985425
738,17,5,0.29411764705882354,12,0,43252.12983091743,13.0,0.12617530588389214
739,11,0,0.0,11,0,167831.5024489857,18.727272727272727,0.11887147834812067
740,16,2,0.125,14,0,1663.4732359099166,32.3125,0.13420484210888875
741,17,5,0.29411764705882354,12,0,915398.8588052498,17.176470588235293,0.12239612241842124
742,16,2,0.125,14,0,90989.18400001086,35.3125,0.12018747167218113
743,14,6,0.42857142857142855,8,0,59033.832829236504,20.642857142857142,0.12021182668487042
744,25,5,0.2,20,0,172893.38859026585,19.28,0.11105859410605923
745,29,6,0.20689655172413793,23,0,96089.67349814164,13.793103448275861,0.12210800165767229
746,16,3,0.1875,13,0,98526.96625835627,27.125,0.09696088622134058
747,17,2,0.11764705882352941,15,0,14010.469661657833,22.647058823529413,0.1286063957096061
748,16,4,0.25,12,0,100214.50224818186,48.3125,0.1446192132923217
749,26,3,0.11538461538461539,23,0,80251.14870252657,14.153846153846153,0.10494485160908565
750,11,3,0.2727272727272727,8,0,103189.35570057231,18.454545454545453,0.12795106199091155
751,18,4,0.2222222222222222,14,0,87702.29860399623,54.55555555555556,0.13298786023020465
752,11,1,0.09090909090909091,10,0,556876.5458259697,14.909090909090908,0.11232909845160938
753,24,6,0.25,18,0,29894.512007943656,16.541666666666668,0.09505221234641618
754,24,2,0.08333333333333333,22,0,314911.59504131495,33.833333333333336,0.11856719831613301
755,11,0,0.0,11,0,5949.253849554673,11.909090909090908,0.12464935690972899
756,18,3,0.16666666666666666,15,0,145078.28083250948,43.833333333333336,0.12346317827514154
757,15,5,0.3333333333333333,10,0,3380.245907737539,15.866666666666667,0.11196499574447598
758,20,2,0.1,18,0,133150.7411661308,58.55,0.10122900761950279
759,13,1,0.07692307692307693,12,0,6947.998320972014,17.46153846153846,0.12446202669203614
760,36,8,0.2222222222222222,28,0,43049.88681285642,46.083333333333336,0.10058220221284687
761,14,5,0.35714285714285715,9,0,6490.693556827389,40.857142857142854,0.10663940092622523
762,11,1,0.09090909090909091,10,0,663433.6827763799,23.454545454545453,0.13750905650239656
763,40,7,0.175,33,0,80962.07995587631,13.675,0.09213777297545445
764,45,7,0.15555555555555556,38,0,179994.26041806035,14.066666666666666,0.10808642931755116
765,34,6,0.17647058823529413,28,0,59775.01105934897,18.323529411764707,0.11696827240774266
766,20,4,0.2,16,0,122138.06221978572,36.05,0.09637596969086293
767,16,3,0.1875,13,0,36484.85741478108,17.0625,0.11136715842263864
768,47,8,0.1702127659574468,39,0,356680.57498322916,19.02127659574468,0.11013692595697029
769,19,3,0.15789473684210525,16,0,19267.263157894737,17.473684210526315,0.09948439752823408
770,43,3,0.06976744186046512,40,0,220150.05728676115,16.372093023255815,0.1052093469675764
771,16,1,0.0625,15,0,24131.28387567715,10.0625,0.08139516985099562
772,12,0,0.0,12,0,0.0,12.916666666666666,0.10172210093945806
773,19,2,0.10526315789473684,17,0,15308.152894495444,9.210526315789474,0.10390011594453513
774,16,1,0.0625,15,0,28597.5,13.4375,0.12061812731809049
775,11,2,0.18181818181818182,9,0,15491.44345872291,11.090909090909092,0.10468925296754751
776,23,5,0.21739130434782608,18,0,114319.60171659318,37.34782608695652,0.10691101802767575
777,25,5,0.2,20,0,12658.20654477343,25.12,0.09861244771569558
778,14,2,0.14285714285714285,12,0,101.68699804545132,11.214285714285714,0.0788376529398933
779,14,1,0.07142857142857142,13,0,3915.301918596568,12.071428571428571,0.09612539917410193
780,11,2,0.18181818181818182,9,0,13717.650728854804,26.0,0.11585983323620329
781,15,1,0.06666666666666667,14,0,0.0,8.8,0.0882751481904984
782,20,6,0.3,14,0,75405.14922248202,15.2,0.13433051983643088
783,30,3,0.1,27,0,215978.0094540015,14.266666666666667,0.09601856162378763
784,14,1,0.07142857142857142,13,0,21906.682286325806,16.357142857142858,0.12743342449004977
785,18,4,0.2222222222222222,14,0,4925.826778411173,12.0,0.11936275191374457
786,19,1,0.05263157894736842,18,0,767.8277954087505,17.42105263157895,0.12402782125767796
787,22,1,0.045454545454545456,21,0,25229.490787670587,14.681818181818182,0.1020274366493838
788,11,1,0.09090909090909091,10,0,0.0,11.090909090909092,0.13738674280882154
789,20,4,0.2,16,0,82647.50378484513,18.85,0.10599708842137626
790,27,5,0.18518518518518517,22,0,35131.202622050936,14.222222222222221,0.11794299776567467
791,24,4,0.16666666666666666,20,0,4600.489599341279,17.291666666666668,0.11490682638414362
792,12,2,0.16666666666666666,10,0,49564.11864923803,10.416666666666666,0.11167701263276127
793,15,2,0.13333333333333333,13,0,1017.3523197102371,20.266666666666666,0.12432366846270722
794,13,3,0.23076923076923078,10,0,5458.752251462292,11.846153846153847,0.10166107347411099
795,21,3,0.14285714285714285,18,0,92444.79171194372,12.476190476190476,0.12127891883810954
796,16,1,0.0625,15,0,45449.30667361384,13.9375,0.11970362457147407
797,38,8,0.21052631578947367,30,0,195958.34256459188,28.236842105263158,0.10932560178853147
798,20,6,0.3,14,0,406312.76216914254,20.2,0.11564003654916385
799,15,4,0.26666666666666666,11,0,37915.426436457536,11.933333333333334,0.10711555447908232
800,43,4,0.09302325581395349,39,0,110176.53743394148,17.86046511627907,0.09757053293257426
801,23,2,0.08695652173913043,21,0,129846.55427695657,13.391304347826088,0.11506609479608955
802,15,2,0.13333333333333333,13,0,33851.02588001694,38.93333333333333,0.09291643279843881
803,28,5,0.17857142857142858,23,0,165719.26606950545,16.285714285714285,0.1271708145952957
804,12,3,0.25,9,0,44608.717745156806,11.916666666666666,0.11998735716379472
805,12,2,0.16666666666666666,10,0,115560.68853902967,11.166666666666666,0.12349751929513965
806,11,3,0.2727272727272727,8,0,0.0,12.727272727272727,0.09555980413615331
807,41,6,0.14634146341463414,35,0,8695.544196101402,14.317073170731707,0.10605787684498445
808,14,4,0.2857142857142857,10,0,294603.6284480669,18.642857142857142,0.11248202378913531
809,11,0,0.0,11,0,8926.64590598383,9.727272727272727,0.11310421505096376
810,20,5,0.25,15,0,135035.84554764797,13.8,0.10073404658412885
811,12,1,0.08333333333333333,11,0,0.0,43.416666666666664,0.12012204950695769
812,18,3,0.16666666666666666,15,0,5084.444444444444,15.833333333333334,0.1136367709395517
813,20,6,0.3,14,0,18410.570719632924,17.9,0.1122816232442759
814,20,0,0.0,20,0,16876.673203945433,24.75,0.09128418310531657
815,17,2,0.11764705882352941,15,0,604642.4895668888,21.764705882352942,0.12931660637947112
816,16,2,0.125,14,0,24779.9762761108,14.8125,0.11064471789627775
817,17,2,0.11764705882352941,15,0,1312.4555947926453,15.352941176470589,0.11293929343286108
818,11,1,0.09090909090909091,10,0,27384.724236690152,14.545454545454545,0.10660796419010357
819,31,8,0.25806451612903225,23,0,41963.65702513805,13.064516129032258,0.1269406590209906
820,11,1,0.09090909090909091,10,0,15771.002409700259,16.09090909090909,0.13686665901877698
821,12,0,0.0,12,0,25057.032483177736,72.16666666666667,0.10396943555049136
822,11,1,0.09090909090909091,10,0,14911.876507239935,50.09090909090909,0.11707182189246179
823,19,2,0.10526315789473684,17,0,184233.60295435114,19.526315789473685,0.117407171739027
824,14,3,0.21428571428571427,11,0,125085.77784802197,64.64285714285714,0.13989713624485908
825,46,6,0.13043478260869565,40,0,288006.75733979075,23.956521739130434,0.11784533731515066
826,12,2,0.16666666666666666,10,0,537.225594545551,45.583333333333336,0.11789548651336164
827,44,9,0.20454545454545456,35,0,46341.50777355596,18.704545454545453,0.11387618689124444
828,12,3,0.25,9,0,310885.21487046336,18.833333333333332,0.1097360832820276
829,26,5,0.19230769230769232,21,0,2114.1302781756326,25.76923076923077,0.08243040405811053
830,15,1,0.06666666666666667,14,0,62310.09941385267,39.6,0.12336163790687055
831,15,2,0.13333333333333333,13,0,72680.92427088504,24.0,0.09668415829939322
832,21,1,0.047619047619047616,20,0,123301.2213451626,11.428571428571429,0.06783853438519746
833,15,2,0.13333333333333333,13,0,183038.2491087903,36.333333333333336,0.11921590697824938
834,16,4,0.25,12,0,62385.1138799064,17.875,0.11713000909352977
835,11,3,0.2727272727272727,8,0,24732.0183512254,16.90909090909091,0.12801613275877022
836,19,3,0.15789473684210525,16,0,18941.298631443853,18.68421052631579,0.11561369283416353
837,24,4,0.16666666666666666,20,0,29461.696931283066,35.416666666666664,0.10105584784578492
838,12,5,0.4166666666666667,7,0,68414.43773049954,47.083333333333336,0.09653647876527914
839,19,4,0.21052631578947367,15,0,10688.795596444794,15.421052631578947,0.10872882586302814
840,23,4,0.17391304347826086,19,0,7599.029596056223,14.043478260869565,0.10339093866272304
841,16,3,0.1875,13,0,6162.482069961689,11.0625,0.10022780133542274
842,40,11,0.275,29,0,22468.738388903883,13.25,0.09946006707019964
843,15,3,0.2,12,0,50485.96002742609,14.8,0.15215876401777859
844,15,1,0.06666666666666667,14,0,67406.38859177583,16.0,0.10584625302328118
845,14,4,0.2857142857142857,10,0,17381.498267700023,13.642857142857142,0.0997795699697429
846,30,6,0.2,24,0,209316.93701618788,19.6,0.1309593227584799
847,31,5,0.16129032258064516,26,0,311122.89794935094,33.193548387096776,0.11094191048416638
848,23,6,0.2608695652173913,17,0,54458.17571797572,16.043478260869566,0.10811747997786819
849,27,7,0.25925925925925924,20,0,255926.94347292202,14.555555555555555,0.11902988485309995
850,30,5,0.16666666666666666,25,0,153211.86693915183,16.166666666666668,0.1294739277434432
851,29,10,0.3448275862068966,19,0,587045.275213425,19.79310344827586,0.1151241446836519
852,11,1,0.09090909090909091,10,0,104171.52472576858,17.272727272727273,0.1281332286488621
853,20,5,0.25,15,0,140318.63218803453,20.15,0.12605872012835737
854,13,2,0.15384615384615385,11,0,2057.8521041116173,11.692307692307692,0.12184283320367645
855,14,1,0.07142857142857142,13,0,5331.2183890032975,15.928571428571429,0.13472369441930282
856,67,7,0.1044776119402985,60,0,284411.8763659901,21.044776119402986,0.09631753112480515
857,12,1,0.08333333333333333,11,0,118767.27713703102,41.5,0.11915590450852824
858,23,7,0.30434782608695654,16,0,356041.0196135798,14.652173913043478,0.09823151812507576
859,14,3,0.21428571428571427,11,0,3787.8248107172735,40.214285714285715,0.1387059008109495
860,13,4,0.3076923076923077,9,0,17740.924278703114,9.615384615384615,0.10051573766623975
861,24,1,0.041666666666666664,23,0,112758.81496727707,17.375,0.09389670463280757
862,13,2,0.15384615384615385,11,0,0.6648351648351648,14.0,0.10841442749101894
863,42,8,0.19047619047619047,34,0,130782.77831580053,18.904761904761905,0.1102946364009992
864,15,3,0.2,12,0,89760.24226507894,13.333333333333334,0.10151947018513585
865,38,6,0.15789473684210525,32,0,3391.8580269355994,14.763157894736842,0.12144959935084304
866,12,4,0.3333333333333333,8,0,209655.58043451395,29.583333333333332,0.09929482312542375
867,18,2,0.1111111111111111,16,0,8373.687266683584,12.277777777777779,0.11542057187047632
868,24,5,0.20833333333333334,19,0,31495.96803484522,12.875,0.08609432722521515
869,35,7,0.2,28,0,209572.57423749942,13.685714285714285,0.11386695821671727
870,27,9,0.3333333333333333,18,0,232658.22224578628,29.51851851851852,0.11743671546725161
871,15,5,0.3333333333333333,10,0,143325.28535235208,14.266666666666667,0.10840576423321462
872,19,5,0.2631578947368421,14,0,314040.8719465593,26.263157894736842,0.08586731093888762
873,19,4,0.21052631578947367,15,0,124576.05388300927,16.94736842105263,0.142708808576625
874,32,7,0.21875,25,0,880207.1786961034,26.0,0.1072356936119933
875,41,9,0.21951219512195122,32,0,92213.75758999672,28.24390243902439,0.12727559331739244
876,22,1,0.045454545454545456,21,0,86089.27430867053,13.545454545454545,0.10406328746195782
877,14,4,0.2857142857142857,10,0,39092.01463462832,48.285714285714285,0.13929624690749629
878,13,2,0.15384615384615385,11,0,0.0,60.0,0.10989913483847405
879,16,1,0.0625,15,0,52711.33468027683,12.75,0.08852635207092902
880,120,23,0.19166666666666668,97,0,269404.2151907988,16.241666666666667,0.09795527128482033
881,24,0,0.0,24,0,54666.36940138069,15.458333333333334,0.11011367487224548
882,18,2,0.1111111111111111,16,0,15330.546953561172,25.88888888888889,0.1228493864370965
883,23,7,0.30434782608695654,16,0,23970.313637475225,11.478260869565217,0.10896349163499577
884,18,2,0.1111111111111111,16,0,51885.12400991205,14.444444444444445,0.11374084769475457
885,24,5,0.20833333333333334,19,0,131765.29215579832,34.125,0.10174416606537721
886,42,9,0.21428571428571427,33,0,346143.72996910074,27.023809523809526,0.11026160236342372
887,26,7,0.2692307692307692,19,0,79458.54013790976,11.153846153846153,0.09312482229534084
888,37,7,0.1891891891891892,30,0,2584421.5465123104,44.62162162162162,0.100493860745589
889,15,3,0.2,12,0,854333.9614229341,60.13333333333333,0.15258764408701964
890,12,5,0.4166666666666667,7,0,8144.146343664203,39.25,0.11211302066948048
891,24,4,0.16666666666666666,20,0,647.9801959870109,15.708333333333334,0.12344261184986109
892,20,8,0.4,12,0,37723.911022092216,16.75,0.08180279182669858
893,12,5,0.4166666666666667,7,0,0.023809523809523808,8.416666666666666,0.07540246608108589
894,30,6,0.2,24,0,122843.66968508209,28.333333333333332,0.127572808438933
895,12,4,0.3333333333333333,8,0,115730.73233266904,23.25,0.14748951643966215
896,15,2,0.13333333333333333,13,0,42156.52678364901,11.533333333333333,0.10480125446406618
897,12,2,0.16666666666666666,10,0,119160.48958341013,17.583333333333332,0.0983954805579033
898,37,10,0.2702702702702703,27,0,66641.60928012514,13.18918918918919,0.09506669365156291
899,21,0,0.0,21,0,23885.330784548867,10.285714285714286,0.1141974427667094
900,30,4,0.13333333333333333,26,0,44330.26441283508,14.8,0.11728636423215198
901,12,2,0.16666666666666666,10,0,61497.31162401691,10.166666666666666,0.07383267465260222
902,14,2,0.14285714285714285,12,0,173568.63341446096,9.214285714285714,0.09223002870309722
903,38,10,0.2631578947368421,28,0,145382.18512868558,16.236842105263158,0.12079294837957973
904,14,4,0.2857142857142857,10,0,75627.29679812145,15.285714285714286,0.13484435533188796
905,13,3,0.23076923076923078,10,0,101744.96432509001,17.846153846153847,0.12722169812481085
906,24,4,0.16666666666666666,20,0,27007.0257288814,29.625,0.1090485570695711
907,27,3,0.1111111111111111,24,0,628378.32080212,28.14814814814815,0.10376965417381398
908,27,8,0.2962962962962963,19,0,1196716.4969819377,37.629629629629626,0.1284182028000941
909,13,3,0.23076923076923078,10,0,198.30997119704728,15.076923076923077,0.09594293707129892
910,17,2,0.11764705882352941,15,0,16755.42748386863,11.470588235294118,0.0762067229110279
911,16,4,0.25,12,0,13409.372736571542,9.375,0.08833438555845884
912,16,0,0.0,16,0,457460.9853304475,12.625,0.11274857794876447
913,16,3,0.1875,13,0,1331.7513691828278,20.5,0.11281990732779243
914,14,4,0.2857142857142857,10,0,72690.45660073517,16.5,0.09502293043538058
915,19,4,0.21052631578947367,15,0,15000.591993878703,16.42105263157895,0.06659820629951914
916,28,5,0.17857142857142858,23,0,44092.46575071295,18.714285714285715,0.10947445556285085
917,34,1,0.029411764705882353,33,0,83209.69777077159,15.323529411764707,0.1090478168803604
918,15,3,0.2,12,0,96046.03750277599,14.866666666666667,0.1004442355120887
919,18,4,0.2222222222222222,14,0,57623.64702018828,17.22222222222222,0.11155871484799201
920,11,1,0.09090909090909091,10,0,76802.39903860501,11.090909090909092,0.11831120188569016
921,11,3,0.2727272727272727,8,0,181361.64175212348,13.272727272727273,0.13499522260489716
922,103,18,0.17475728155339806,85,0,604479.6275694215,27.41747572815534,0.12604290525894524
923,13,1,0.07692307692307693,12,0,5701.8841411125695,12.923076923076923,0.12091779169042242
924,19,2,0.10526315789473684,17,0,93096.88813632629,21.526315789473685,0.11628102689866698
925,22,3,0.13636363636363635,19,0,18827.104061484773,15.045454545454545,0.08794885730970475
926,16,3,0.1875,13,0,869267.8497805782,25.9375,0.1057018690708134
927,11,3,0.2727272727272727,8,0,51122.157301525614,37.18181818181818,0.12145181140550361
928,19,2,0.10526315789473684,17,0,27402.659292206063,16.157894736842106,0.10868258033662082
929,15,4,0.26666666666666666,11,0,191495.8235302653,31.066666666666666,0.13173954345401062
930,18,1,0.05555555555555555,17,0,219309.92392901448,24.22222222222222,0.1525119561845893
931,31,4,0.12903225806451613,27,0,32718.498968911248,15.064516129032258,0.0986550900167589
932,24,1,0.041666666666666664,23,0,50922.26193268186,12.833333333333334,0.0901650980906558
933,22,4,0.18181818181818182,18,0,4312.293692115732,21.045454545454547,0.09331938152667152
934,16,1,0.0625,15,0,0.0,7.1875,0.09025575605083579
935,24,5,0.20833333333333334,19,0,80839.65145133267,16.625,0.14116807005886625
936,15,2,0.13333333333333333,13,0,128247.41912608324,10.6,0.06558173888620461
937,30,3,0.1,27,0,782626.3982833967,60.666666666666664,0.12660470916060187
938,10,1,0.1,9,0,0.0,7.1,0.07475026856891415
939,52,9,0.17307692307692307,43,0,140332.32033638092,12.346153846153847,0.08863003542806379
940,21,4,0.19047619047619047,17,0,1452.6349206339196,11.333333333333334,0.10456000592943275
941,22,4,0.18181818181818182,18,0,130105.5364000203,15.954545454545455,0.1077169073796235
942,28,7,0.25,21,0,91343.47840097014,15.714285714285714,0.11316050027498384
943,12,2,0.16666666666666666,10,0,1633.2213883925467,10.75,0.10476801073592464
944,14,2,0.14285714285714285,12,0,79.23090939820683,13.714285714285714,0.08078428862517469
945,30,5,0.16666666666666666,25,0,198476.1647447327,14.466666666666667,0.10919510642564269
946,24,4,0.16666666666666666,20,0,191650.06041241318,48.625,0.13209599937454292
947,30,4,0.13333333333333333,26,0,18732.990551201237,11.833333333333334,0.10852340469541576
948,34,6,0.17647058823529413,28,0,29359.545442556457,14.617647058823529,0.1288731730702701
949,19,1,0.05263157894736842,18,0,459116.98817774357,21.63157894736842,0.11107581388703998
950,13,2,0.15384615384615385,11,0,2298.893998228664,14.538461538461538,0.08636449808178609
951,13,1,0.07692307692307693,12,0,154482.2465869701,25.23076923076923,0.10980178607859216
952,13,3,0.23076923076923078,10,0,142505.5340581089,13.615384615384615,0.12540639941125267
953,13,2,0.15384615384615385,11,0,612408.0185060577,24.53846153846154,0.11472286150517319
954,15,2,0.13333333333333333,13,0,155488.37875210677,18.933333333333334,0.08092209800260006
955,17,4,0.23529411764705882,13,0,36777.49698092852,20.705882352941178,0.11736230898861519
956,12,2,0.16666666666666666,10,0,133806.33839007677,12.916666666666666,0.0990214194511262
957,23,3,0.13043478260869565,20,0,96815.70835028942,25.869565217391305,0.12233130687646614
958,18,1,0.05555555555555555,17,0,22773.69146472611,13.666666666666666,0.11327483553900976
959,23,3,0.13043478260869565,20,0,576167.8306078613,20.82608695652174,0.11595963851406182
960,15,4,0.26666666666666666,11,0,6121.672650927271,13.4,0.12291086606012909
961,42,10,0.23809523809523808,32,0,370890.4129001462,20.595238095238095,0.1333924792502707
962,20,2,0.1,18,0,43623.90858353922,10.45,0.1243434851215438
963,11,0,0.0,11,0,14883.932191850483,12.454545454545455,0.10746651418912058
964,12,0,0.0,12,0,32065.528610806,12.916666666666666,0.0889463701720943
965,14,4,0.2857142857142857,10,0,90521.57273340707,17.857142857142858,0.1288163388294699
966,33,3,0.09090909090909091,30,0,63416.07109136825,25.21212121212121,0.11721632799553439
967,22,2,0.09090909090909091,20,0,100130.43842429788,12.181818181818182,0.07357448148088547
968,32,4,0.125,28,0,12929.06124705325,14.90625,0.12371344322394061
969,32,5,0.15625,27,0,95746.07534924928,18.53125,0.097997204928438
970,11,4,0.36363636363636365,7,0,102935.84446917837,68.27272727272727,0.12080826837211216
971,16,3,0.1875,13,0,424987.6579518112,25.0,0.1200571757381732
972,16,3,0.1875,13,0,160096.24045819574,17.5625,0.12111155368742471
973,81,15,0.18518518518518517,66,0,9864.151847605908,13.234567901234568,0.11015000415783772
974,12,1,0.08333333333333333,11,0,107294.64801107511,38.333333333333336,0.13479069585570144
975,16,3,0.1875,13,0,815938.8872442408,53.875,0.11316086682673546
976,33,4,0.12121212121212122,29,0,105506.66907402658,12.818181818181818,0.0830053955857211
977,34,4,0.11764705882352941,30,0,60740.94340057715,9.911764705882353,0.09253233739005207
978,15,4,0.26666666666666666,11,0,47702.234156329054,11.266666666666667,0.12204101276586869
979,17,4,0.23529411764705882,13,0,133717.5961573709,42.1764705882353,0.12083465542979294
980,39,9,0.23076923076923078,30,0,62108.91993144153,28.076923076923077,0.10934450906039281
981,13,3,0.23076923076923078,10,0,0.0,7.6923076923076925,0.0945337604775677
982,35,5,0.14285714285714285,30,0,231685.16891221094,19.8,0.12955553613320747
983,17,2,0.11764705882352941,15,0,140078.26421278997,23.058823529411764,0.14637218598410634
984,37,11,0.2972972972972973,26,0,276735.63082104083,20.81081081081081,0.10889654631604083
985,24,6,0.25,18,0,66536.73002879304,19.708333333333332,0.12920704361116578
986,13,3,0.23076923076923078,10,0,41960.42909711471,18.076923076923077,0.11207075640489636
987,14,3,0.21428571428571427,11,0,34242.01922189177,12.428571428571429,0.12206960027902385
988,23,4,0.17391304347826086,19,0,42946.527321725756,12.0,0.10487946127784258
989,43,6,0.13953488372093023,37,0,69906.29897577588,17.511627906976745,0.13664582301384354
990,11,2,0.18181818181818182,9,0,8429.386264209073,14.727272727272727,0.12356488647930336
991,15,1,0.06666666666666667,14,0,69767.59728254996,13.933333333333334,0.11739414218863944
992,32,3,0.09375,29,0,112808.40868922777,17.25,0.13486278767377213
993,38,4,0.10526315789473684,34,0,14470.92984816989,12.447368421052632,0.1203870695200728
994,19,1,0.05263157894736842,18,0,1123718.3286231356,73.21052631578948,0.1228718374846805
995,11,1,0.09090909090909091,10,0,280880.1057755882,19.0,0.12516788006691726
996,29,4,0.13793103448275862,25,0,129615.17051789667,15.0,0.09361192443918279
997,21,6,0.2857142857142857,15,0,458810.68560064636,22.523809523809526,0.11472686707959066
998,27,1,0.037037037037037035,26,0,133943.1795014015,36.592592592592595,0.10997408357889496
999,11,0,0.0,11,0,16639.636363636375,7.636363636363637,0.10215126013796723
1000,13,4,0.3076923076923077,9,0,3063.4951542282574,46.07692307692308,0.11217418257152066
1001,18,1,0.05555555555555555,17,0,307126.3289339394,18.38888888888889,0.10263093580489419
1002,17,1,0.058823529411764705,16,0,4869.028783863494,12.0,0.10389233650607037
1003,21,4,0.19047619047619047,17,0,10206.494607340997,15.714285714285714,0.10067870543080011
1004,10,3,0.3,7,0,111599.88835960694,10.0,0.11529979804033778
1005,18,6,0.3333333333333333,12,0,15217.38908674434,18.055555555555557,0.10380464119504618
1006,25,3,0.12,22,0,77327.63774834295,14.32,0.11386432144219118
1007,18,3,0.16666666666666666,15,0,72596.20440090372,17.11111111111111,0.12169564034324935
1008,16,6,0.375,10,0,5720.000000000001,12.0,0.1003582050288091
1009,11,1,0.09090909090909091,10,0,9286.298642581563,13.818181818181818,0.12147319008832778
1010,29,4,0.13793103448275862,25,0,406096.2131679737,35.793103448275865,0.08851488179278574
1011,17,1,0.058823529411764705,16,0,570983.7173796311,22.647058823529413,0.1308837730273276
1012,19,3,0.15789473684210525,16,0,0.0,14.473684210526315,0.08999060595877886
1013,43,9,0.20930232558139536,34,0,140220.5091216387,22.3953488372093,0.10624228840710119
1014,16,4,0.25,12,0,30954.987446169678,21.5625,0.13447088049799194
1015,28,11,0.39285714285714285,17,0,28412.821146941827,12.0,0.11659904517779326
1016,41,5,0.12195121951219512,36,0,279246.12417589343,13.097560975609756,0.1073800323805017
1017,11,1,0.09090909090909091,10,0,40115.57477770415,47.54545454545455,0.0938013589000159
1018,33,7,0.21212121212121213,26,0,897730.7100965003,38.60606060606061,0.11674114606994107
1019,35,7,0.2,28,0,278971.8605443291,15.17142857142857,0.10703213317884952
1020,17,5,0.29411764705882354,12,0,18243.647086547735,40.8235294117647,0.13632746179564428
1021,47,7,0.14893617021276595,40,0,67197.32801415848,20.127659574468087,0.11748244098228271
1022,13,2,0.15384615384615385,11,0,0.021409624857900718,15.076923076923077,0.10378411774496882
1023,19,2,0.10526315789473684,17,0,128694.0577509904,15.368421052631579,0.1302903663814128
1024,19,2,0.10526315789473684,17,0,646146.7583780633,66.3157894736842,0.10091874936714193
1025,20,4,0.2,16,0,74792.27826318957,42.0,0.13749930127632864
1026,19,2,0.10526315789473684,17,0,49674.70941469706,11.0,0.10060216276789721
1027,20,4,0.2,16,0,31455.300672513764,12.4,0.0913975947955523
1028,20,8,0.4,12,0,188730.5811784745,13.25,0.11501234907614807
1029,15,3,0.2,12,0,11169.603581614148,11.266666666666667,0.11376993738996029
1030,35,6,0.17142857142857143,29,0,33303.750160850395,14.485714285714286,0.11642132365663514
1031,25,4,0.16,21,0,185225.921597989,24.64,0.11827619446222389
1032,16,3,0.1875,13,0,58331.62434133294,19.4375,0.10039660664917048
1033,39,7,0.1794871794871795,32,0,47461.74817756016,25.846153846153847,0.1194648037142571
1034,29,4,0.13793103448275862,25,0,74529.96338421652,19.620689655172413,0.09628004386698998
1035,16,1,0.0625,15,0,290213.88155667833,15.6875,0.1404796042329285
1036,12,4,0.3333333333333333,8,0,159437.2599831826,53.25,0.1104040030987015
1037,31,5,0.16129032258064516,26,0,569416.6686626895,38.064516129032256,0.11921260869633535
1038,14,2,0.14285714285714285,12,0,4428.2080365874635,18.0,0.08426754985180664
1039,39,11,0.28205128205128205,28,0,538503.4460939353,27.743589743589745,0.12698082743009412
1040,11,1,0.09090909090909091,10,0,619403.854896115,40.54545454545455,0.14588641057144985
1041,15,2,0.13333333333333333,13,0,126522.42656594544,17.333333333333332,0.12895573375882918
1042,36,4,0.1111111111111111,32,0,634739.9830646182,49.02777777777778,0.1366098379038438
1043,15,0,0.0,15,0,0.2,8.933333333333334,0.09231065304132703
1044,18,5,0.2777777777777778,13,0,41693.76741848208,14.166666666666666,0.1324871897035914
1045,37,5,0.13513513513513514,32,0,253529.6715706535,18.7027027027027,0.11881018171354482
1046,19,2,0.10526315789473684,17,0,5863.016402042668,17.94736842105263,0.12800701950469276
1047,19,3,0.15789473684210525,16,0,128946.04439968574,38.26315789473684,0.13675550359909627
1048,13,1,0.07692307692307693,12,0,0.0,12.923076923076923,0.1075236088162364
1049,11,4,0.36363636363636365,7,0,72072.18522452914,7.818181818181818,0.11800306168036977
1050,28,8,0.2857142857142857,20,0,31392.789892811754,11.357142857142858,0.10666018424873634
1051,25,8,0.32,17,0,753.021063776334,15.08,0.08683112155802374
1052,22,6,0.2727272727272727,16,0,71843.52371538548,17.454545454545453,0.07676470526409954
1053,14,3,0.21428571428571427,11,0,19617.0,18.785714285714285,0.11196925770920106
1054,14,2,0.14285714285714285,12,0,170087.92366007707,16.928571428571427,0.09939785188583884
1055,22,1,0.045454545454545456,21,0,457824.4305608365,20.636363636363637,0.12253464219798893
1056,12,1,0.08333333333333333,11,0,142299.43122272048,16.916666666666668,0.11920155462832578
1057,20,5,0.25,15,0,0.0,18.7,0.11123309317087315
1058,12,1,0.08333333333333333,11,0,74192.73313605318,11.416666666666666,0.11405345823211627
1059,25,3,0.12,22,0,118263.71990264431,14.44,0.09779296101725075
1060,28,5,0.17857142857142858,23,0,142945.52434611996,21.357142857142858,0.11205035380368923
1061,10,4,0.4,6,0,0.0,10.9,0.07464500429892111
1062,13,2,0.15384615384615385,11,0,329874.64323822845,17.46153846153846,0.0995587146261909
1063,14,1,0.07142857142857142,13,0,10488.974308201343,14.642857142857142,0.13735661572427535
1064,22,4,0.18181818181818182,18,0,43616.24916526074,19.5,0.10910542571221464
1065,15,5,0.3333333333333333,10,0,26523.258954771518,16.266666666666666,0.10649387485061722
1066,17,8,0.47058823529411764,9,0,2853.6619008252464,11.294117647058824,0.09176659100350311
1067,17,6,0.35294117647058826,11,0,48602.60108734284,15.764705882352942,0.12292101829044597
1068,33,10,0.30303030303030304,23,0,566488.026353585,37.90909090909091,0.09827627029419143
1069,13,5,0.38461538461538464,8,0,182172.06452435578,18.0,0.08999520269279705
1070,13,2,0.15384615384615385,11,0,248668.35527996675,16.0,0.08010342192809766
1071,26,4,0.15384615384615385,22,0,98472.08454063929,19.76923076923077,0.11272886104307099
1072,23,4,0.17391304347826086,19,0,324532.3351684481,20.565217391304348,0.11965946102833412
1073,14,3,0.21428571428571427,11,0,91756.36497733396,24.285714285714285,0.1489807956245278
1074,13,2,0.15384615384615385,11,0,277013.18494573276,19.307692307692307,0.12523879466878002
1075,14,4,0.2857142857142857,10,0,885869.3031861745,23.071428571428573,0.1321172567997389
1076,40,10,0.25,30,0,73481.80313174374,32.6,0.11787546013570442
1077,27,7,0.25925925925925924,20,0,666150.38481865,18.62962962962963,0.10524792790102973
1078,20,5,0.25,15,0,26810.221248712063,30.65,0.1270260843448323
1079,13,0,0.0,13,0,452950.7694303058,19.46153846153846,0.11696896615241965
1080,25,5,0.2,20,0,49986.87085106613,16.6,0.09871750540694758
1081,19,3,0.15789473684210525,16,0,159197.29730780865,36.63157894736842,0.11921650518403717
1082,13,2,0.15384615384615385,11,0,4825.786605530022,97.15384615384616,0.1520110439062078
1083,61,8,0.13114754098360656,53,0,418482.4191606164,24.770491803278688,0.11302365451175624
1084,21,3,0.14285714285714285,18,0,20293.553997858155,14.952380952380953,0.11211910660191589
1085,15,4,0.26666666666666666,11,0,2744.154994822304,15.0,0.10058672018119222
1086,23,4,0.17391304347826086,19,0,83962.74835969693,11.347826086956522,0.1170612764382015
1087,12,1,0.08333333333333333,11,0,278472.34771498205,27.416666666666668,0.14001487201280097
1088,15,2,0.13333333333333333,13,0,13511.78709663486,19.533333333333335,0.15494828060136273
1089,21,5,0.23809523809523808,16,0,297127.09045358346,12.428571428571429,0.09190278789999565
1090,11,0,0.0,11,0,0.0,7.7272727272727275,0.12688184659880328
1091,24,6,0.25,18,0,24580.914014441438,13.791666666666666,0.10238836257061713
1092,16,4,0.25,12,0,164670.2477715616,18.625,0.11049372189071241
1093,15,3,0.2,12,0,6614.123981647225,14.666666666666666,0.12408152337625385
1094,14,4,0.2857142857142857,10,0,493857.4046613683,51.0,0.08718330233485173
1095,13,2,0.15384615384615385,11,0,146788.48359950838,17.692307692307693,0.08104522678138963
1096,19,2,0.10526315789473684,17,0,123508.9958880942,39.36842105263158,0.1360389310117273
1097,21,2,0.09523809523809523,19,0,113987.61668203946,10.095238095238095,0.09703149883965694
1098,29,5,0.1724137931034483,24,0,265138.3071324373,32.58620689655172,0.12449055570462318
1099,11,2,0.18181818181818182,9,0,12167.486669775659,50.90909090909091,0.12940884674048794
1100,18,1,0.05555555555555555,17,0,22134.77452625399,37.77777777777778,0.11690573535559579
1101,42,8,0.19047619047619047,34,0,92217.28155776869,23.61904761904762,0.11031787712584894
1102,14,2,0.14285714285714285,12,0,141810.86997957036,21.428571428571427,0.1350591358871593
1103,19,0,0.0,19,0,18176.37191507462,36.578947368421055,0.13157541131097253
1104,12,2,0.16666666666666666,10,0,0.0,15.666666666666666,0.08745901466641953
1105,19,1,0.05263157894736842,18,0,22178.47043001247,19.210526315789473,0.10610691801555276
1106,20,5,0.25,15,0,6403.988986141397,17.15,0.08352144085913596
1107,13,3,0.23076923076923078,10,0,13010.647803385322,16.46153846153846,0.06693731841431948
1108,56,8,0.14285714285714285,48,0,811902.4779718438,25.446428571428573,0.10956759284778518
1109,16,1,0.0625,15,0,56440.68887244837,11.0,0.09880247015826413
1110,45,11,0.24444444444444444,34,0,580581.3687461808,22.377777777777776,0.12352849682862116
1111,12,2,0.16666666666666666,10,0,0.0,11.166666666666666,0.12510756178968552
1112,21,5,0.23809523809523808,16,0,26465.97846288101,10.857142857142858,0.0915456737702377
1113,14,1,0.07142857142857142,13,0,14698.592413274442,21.285714285714285,0.11238778721032923
1114,15,4,0.26666666666666666,11,0,13257.322178383936,14.733333333333333,0.1413234572667708
1115,22,3,0.13636363636363635,19,0,64494.614152496244,20.272727272727273,0.11030208107545718
1116,15,4,0.26666666666666666,11,0,142743.16419452237,18.6,0.10377459607535398
1117,20,2,0.1,18,0,301.6376108627567,14.2,0.09936818649819842
1118,14,2,0.14285714285714285,12,0,294078.5946942813,29.642857142857142,0.1428542943299521
1119,14,5,0.35714285714285715,9,0,2415.215702951865,15.0,0.13228137145383018
1120,12,6,0.5,6,0,0.0,5.916666666666667,0.0688611428275519
1121,38,6,0.15789473684210525,32,0,15530.513444175209,17.31578947368421,0.12408383246438819
1122,12,4,0.3333333333333333,8,0,0.0,9.5,0.09879860913893135
1123,47,9,0.19148936170212766,38,0,74989.0186006864,33.297872340425535,0.11577549765615483
1124,17,4,0.23529411764705882,13,0,201253.9351408833,45.94117647058823,0.12400364965441704
1125,61,7,0.11475409836065574,54,0,294386.6622177863,39.42622950819672,0.1108383229419201
1126,26,4,0.15384615384615385,22,0,155970.95038026903,32.88461538461539,0.10362429661824166
1127,31,5,0.16129032258064516,26,0,53141.89342050326,16.967741935483872,0.13886173381780026
1128,24,9,0.375,15,0,6367.176851375579,24.625,0.12048807239875237
1129,18,3,0.16666666666666666,15,0,12117.86283437041,14.88888888888889,0.1330453184082182
1130,15,1,0.06666666666666667,14,0,379580.2513466189,49.6,0.09768648728555142
1131,12,1,0.08333333333333333,11,0,432903.7592208439,37.666666666666664,0.1256836325951166
1132,13,2,0.15384615384615385,11,0,143060.20467974583,14.923076923076923,0.11766693058444624
1133,47,8,0.1702127659574468,39,0,38752.12529865091,16.70212765957447,0.12780911083062838
1134,24,6,0.25,18,0,67939.28602820291,14.458333333333334,0.1078702603522746
1135,15,2,0.13333333333333333,13,0,12202.400000000001,13.0,0.1544355766508708
1136,12,5,0.4166666666666667,7,0,30505.75,10.083333333333334,0.0891686597989111
1137,12,0,0.0,12,0,92.5,7.666666666666667,0.06866194120881276
1138,16,4,0.25,12,0,63230.16728915105,21.0625,0.12755031081418727
1139,16,0,0.0,16,0,170983.38745157828,36.5,0.10953322842107083
1140,14,2,0.14285714285714285,12,0,263648.06405299896,42.214285714285715,0.12308670709705152
1141,13,1,0.07692307692307693,12,0,350036.5968099495,22.46153846153846,0.13727817543205986
1142,19,4,0.21052631578947367,15,0,24815.983412913727,12.947368421052632,0.1216718774977405
1143,23,1,0.043478260869565216,22,0,95614.14751185372,14.478260869565217,0.11632938941852693
1144,17,3,0.17647058823529413,14,0,1486.4456243242162,14.235294117647058,0.09623889554827304
1145,12,2,0.16666666666666666,10,0,26415.031754324682,18.833333333333332,0.11677938181690976
1146,38,5,0.13157894736842105,33,0,46968.92692714252,18.842105263157894,0.12438667234111123
1147,13,2,0.15384615384615385,11,0,308860.37947489746,24.53846153846154,0.11920777444057726
1148,15,2,0.13333333333333333,13,0,63417.372656291765,82.93333333333334,0.1307448923742308
1149,11,3,0.2727272727272727,8,0,134347.65260190217,20.90909090909091,0.10454588059280416
1150,20,2,0.1,18,0,96908.68683862453,33.05,0.116677920169501
1151,26,6,0.23076923076923078,20,0,445383.5109519438,39.88461538461539,0.12180590793256879
1152,21,4,0.19047619047619047,17,0,11868.4966606683,17.142857142857142,0.12074106520192415
1153,14,1,0.07142857142857142,13,0,9636.697534863071,11.5,0.09261228196188122
1154,12,5,0.4166666666666667,7,0,10270.880908670913,10.166666666666666,0.12783297490642723
1155,13,4,0.3076923076923077,9,0,99868.76370891111,13.615384615384615,0.13516080783958695
1156,28,6,0.21428571428571427,22,0,12495.571138869407,15.142857142857142,0.11695035815582233
1157,14,1,0.07142857142857142,13,0,463.80424239215336,12.0,0.10421317077182861
1158,41,4,0.0975609756097561,37,0,44290.002302021676,11.951219512195122,0.11269794337759406
1159,13,4,0.3076923076923077,9,0,7967.5335262419385,11.538461538461538,0.10965920245447894
1160,24,4,0.16666666666666666,20,0,67691.60672195941,16.333333333333332,0.10981754858221715
1161,24,2,0.08333333333333333,22,0,71285.25395968147,28.958333333333332,0.12605461704533583
1162,22,5,0.22727272727272727,17,0,328068.3079936071,32.45454545454545,0.12763154827790046
1163,18,2,0.1111111111111111,16,0,7572.563871735965,12.722222222222221,0.10602618220805379
1164,14,5,0.35714285714285715,9,0,23024.142891322233,45.0,0.11080811571610723
1165,14,1,0.07142857142857142,13,0,31559.001331342795,12.214285714285714,0.11668703101790026
1166,17,3,0.17647058823529413,14,0,187718.33155748548,12.882352941176471,0.12161179658837046
1167,24,3,0.125,21,0,31839.678460071213,15.125,0.11107789777722438
1168,13,2,0.15384615384615385,11,0,179510.4741215322,20.153846153846153,0.13695647667074615
1169,10,0,0.0,10,0,348.8291747491311,14.5,0.09849736032789638
1170,13,1,0.07692307692307693,12,0,73613.58794592811,18.0,0.12428082337004175
1171,24,6,0.25,18,0,29641.072777815858,39.125,0.11457474611016262
1172,20,5,0.25,15,0,68231.76601010353,18.2,0.09239566806800283
1173,22,1,0.045454545454545456,21,0,195311.99439194557,15.318181818181818,0.12383047813595542
1174,13,2,0.15384615384615385,11,0,88622.7698153997,16.46153846153846,0.10833457614747134
1175,27,2,0.07407407407407407,25,0,10082.12245008604,15.0,0.10019764041070849
1176,24,4,0.16666666666666666,20,0,65940.3842607747,30.041666666666668,0.11660277202767493
1177,17,2,0.11764705882352941,15,0,66762.87604747358,18.58823529411765,0.14136923693930226
1178,16,0,0.0,16,0,125619.83835343798,50.25,0.1413645654408821
1179,12,1,0.08333333333333333,11,0,18860.19056923607,12.333333333333334,0.11065546407489217
1180,19,4,0.21052631578947367,15,0,33594.446517072574,31.736842105263158,0.09967338553801047
1181,25,2,0.08,23,0,126748.70006988257,15.88,0.09396491523684546
1182,20,2,0.1,18,0,76872.77156251778,17.7,0.1175188006983761
1183,62,6,0.0967741935483871,56,0,127752.39610973159,19.70967741935484,0.12121237915787912
1184,16,5,0.3125,11,0,157177.7326206456,12.875,0.11235811398452614
1185,23,3,0.13043478260869565,20,0,36338.06935587538,23.782608695652176,0.09560900582350357
1186,16,1,0.0625,15,0,0.07083333333333333,14.875,0.09997993906044086
1187,25,6,0.24,19,0,78316.35432055002,13.44,0.12156579583105837
1188,15,1,0.06666666666666667,14,0,103827.25895034088,11.733333333333333,0.12086125934910832
1189,28,5,0.17857142857142858,23,0,151955.54513120014,21.678571428571427,0.11380013755867106
1190,27,8,0.2962962962962963,19,0,24322.743401597814,15.222222222222221,0.13392523598661935
1191,16,3,0.1875,13,0,13483.294580513935,21.625,0.08891152528083439
1192,17,4,0.23529411764705882,13,0,157532.23324662092,28.705882352941178,0.11669250702495751
1193,38,7,0.18421052631578946,31,0,134419.86019109227,17.842105263157894,0.11451441803077617
1194,16,1,0.0625,15,0,9450.122488455389,14.4375,0.1148910831659758
1195,16,0,0.0,16,0,14946.201785318864,32.6875,0.10504841564939614
1196,16,4,0.25,12,0,165283.1881896737,33.6875,0.1279209038161975
1197,51,10,0.19607843137254902,41,0,49408.328550828235,26.92156862745098,0.11918490639667909
1198,17,4,0.23529411764705882,13,0,30278.404818507872,33.35294117647059,0.11825975578143545
1199,49,8,0.16326530612244897,41,0,492951.2186564734,23.244897959183675,0.11563358168263635
1200,16,5,0.3125,11,0,153511.35496602,16.125,0.08343981959664193
1201,14,3,0.21428571428571427,11,0,163178.37528255495,18.142857142857142,0.11198048692889565
1202,15,3,0.2,12,0,19.323690480561066,13.6,0.1165421429690732
1203,15,1,0.06666666666666667,14,0,96358.34016114792,20.466666666666665,0.12230024631932429
1204,20,6,0.3,14,0,29114.45209558435,9.4,0.0916246496960923
1205,25,0,0.0,25,0,42878.94726120376,12.36,0.10295263935657761
1206,12,2,0.16666666666666666,10,0,449264.36462140875,23.583333333333332,0.11190243711968789
1207,22,3,0.13636363636363635,19,0,27715.889387800635,11.681818181818182,0.11821432514840019
1208,22,8,0.36363636363636365,14,0,14159.527090187958,13.909090909090908,0.10105618801609868
1209,12,4,0.3333333333333333,8,0,0.0,11.25,0.08916916635209367
1210,29,4,0.13793103448275862,25,0,3184.4553925479177,19.689655172413794,0.11476240620417781
1211,14,3,0.21428571428571427,11,0,73990.26991278825,48.285714285714285,0.1396773143909058
1212,12,2,0.16666666666666666,10,0,26951.897616591134,43.666666666666664,0.10451653225840751
1213,22,3,0.13636363636363635,19,0,38081.805706695624,17.045454545454547,0.10622817937951301
1214,11,1,0.09090909090909091,10,0,62935.281996350015,18.90909090909091,0.11272187131550493
1215,24,5,0.20833333333333334,19,0,101643.37158144727,15.416666666666666,0.12544530763559045
1216,17,4,0.23529411764705882,13,0,34431.28657223078,33.294117647058826,0.1193668554553511
1217,27,2,0.07407407407407407,25,0,339480.53663970827,45.407407407407405,0.1335863444728058
1218,32,4,0.125,28,0,16936.871567381088,15.84375,0.08991642040791084
1219,22,7,0.3181818181818182,15,0,169.20295388760746,11.181818181818182,0.11162210461918166
1220,19,3,0.15789473684210525,16,0,162885.11185016335,40.10526315789474,0.12493902351466554
1221,23,5,0.21739130434782608,18,0,108117.65219436481,14.73913043478261,0.10713310056626076
1222,17,3,0.17647058823529413,14,0,7659.056088015094,22.705882352941178,0.11816535795691975
1223,23,3,0.13043478260869565,20,0,264901.5984650327,16.52173913043478,0.11726537814470907
1224,23,4,0.17391304347826086,19,0,11370.846526556168,43.56521739130435,0.11449140463646071
1225,52,9,0.17307692307692307,43,0,123399.6238317869,23.557692307692307,0.12056785153336019
1226,13,2,0.15384615384615385,11,0,85893.03909470717,8.461538461538462,0.07856999261357085
1227,83,15,0.18072289156626506,68,0,33907.087993828936,16.91566265060241,0.10850216443768568
1228,12,2,0.16666666666666666,10,0,69754.77041251196,10.416666666666666,0.10619888188227833
1229,12,3,0.25,9,0,0.0,10.083333333333334,0.06150116341040498
1230,17,4,0.23529411764705882,13,0,66848.27271769445,12.470588235294118,0.10345151847800903
1231,26,2,0.07692307692307693,24,0,490262.9520437551,19.076923076923077,0.1209527478075651
1232,21,2,0.09523809523809523,19,0,26441.92506217218,24.80952380952381,0.11497938946052709
1233,16,3,0.1875,13,0,220.03683868653906,15.9375,0.14022722175190916
1234,21,4,0.19047619047619047,17,0,121826.69739861507,19.0,0.10337354110236718
1235,12,4,0.3333333333333333,8,0,83927.52969955186,14.5,0.1346092436387041
1236,11,2,0.18181818181818182,9,0,76268.65548844518,10.454545454545455,0.09393082687816653
1237,35,6,0.17142857142857143,29,0,278051.7309922345,36.94285714285714,0.13447981881235016
1238,25,6,0.24,19,0,34783.885847203004,12.88,0.11573007491660922
1239,11,4,0.36363636363636365,7,0,36439.12212316649,20.636363636363637,0.1196917970404356
1240,11,1,0.09090909090909091,10,0,4697.694061293317,14.363636363636363,0.08358124891410884
1241,13,5,0.38461538461538464,8,0,47217.26844429089,18.53846153846154,0.12158279337963472
1242,32,7,0.21875,25,0,326.1839601085006,10.78125,0.11377711217964695
1243,17,5,0.29411764705882354,12,0,3.0817456064138518,28.0,0.1187364021612403
1244,11,2,0.18181818181818182,9,0,776.0579817823223,29.0,0.11998973640287591
1245,31,4,0.12903225806451613,27,0,31897.440315304844,16.225806451612904,0.12106044118845274
1246,23,2,0.08695652173913043,21,0,31364.299466971388,12.91304347826087,0.11309509059925035
1247,14,4,0.2857142857142857,10,0,46129.57183539353,45.07142857142857,0.10346523465572807
1248,17,3,0.17647058823529413,14,0,51418.1045495201,16.58823529411765,0.08784015034913294
1249,19,4,0.21052631578947367,15,0,1.2951963241436928,9.31578947368421,0.0823635457621323
1250,13,2,0.15384615384615385,11,0,29406.331006565928,12.307692307692308,0.10606376685057313
1251,36,6,0.16666666666666666,30,0,29841.634548734797,29.97222222222222,0.12512550569191166
1252,43,7,0.16279069767441862,36,0,219885.6006057268,39.58139534883721,0.10264127479925506
1253,20,1,0.05,19,0,43008.16848372436,20.0,0.10232215246700442
1254,14,3,0.21428571428571427,11,0,168853.46522840712,30.714285714285715,0.11411003865223027
1255,21,3,0.14285714285714285,18,0,56.10924278849337,11.666666666666666,0.0979220620832842
1256,22,4,0.18181818181818182,18,0,27951.46323692988,14.454545454545455,0.08264206740791664
1257,22,2,0.09090909090909091,20,0,9055.872158353946,12.636363636363637,0.09314262601848779
1258,25,6,0.24,19,0,45420.372979566484,11.8,0.10615701683066227
1259,18,3,0.16666666666666666,15,0,503.37190206206105,15.333333333333334,0.08754162052165061
1260,19,6,0.3157894736842105,13,0,186672.40916621397,18.57894736842105,0.10440532762728123
1261,12,5,0.4166666666666667,7,0,166718.6650631736,26.0,0.13185289933782693
1262,18,3,0.16666666666666666,15,0,256897.43258278337,13.38888888888889,0.1148713030473253
1263,19,1,0.05263157894736842,18,0,888.4424735846685,11.421052631578947,0.10554927861795782
1264,11,2,0.18181818181818182,9,0,7936.030090100798,7.363636363636363,0.12323587860734139
1265,14,4,0.2857142857142857,10,0,12563.18200593092,14.785714285714286,0.1237758861206665
1266,11,2,0.18181818181818182,9,0,253325.68537834202,16.454545454545453,0.09691538584141193
1267,52,6,0.11538461538461539,46,0,99507.19977258262,13.307692307692308,0.1110331462623393
1268,16,1,0.0625,15,0,271460.7707007788,39.5625,0.09941112908744193
1269,17,2,0.11764705882352941,15,0,22000.35807777304,15.823529411764707,0.11259100878874963
1270,13,3,0.23076923076923078,10,0,52927.93905877567,18.692307692307693,0.10394085330007333
1271,28,7,0.25,21,0,8443.903675829142,38.142857142857146,0.12683562653071986
1272,27,2,0.07407407407407407,25,0,121379.06651142346,18.51851851851852,0.12078781241983975
1273,17,4,0.23529411764705882,13,0,19828.099775359176,18.705882352941178,0.11793382743957048
1274,30,5,0.16666666666666666,25,0,24980.98404639409,32.333333333333336,0.10561875796167679
1275,24,6,0.25,18,0,49993.52853986289,16.416666666666668,0.11382968761695127
1276,26,1,0.038461538461538464,25,0,74014.80771100408,14.576923076923077,0.10533131767410087
1277,48,6,0.125,42,0,157060.6258984198,30.458333333333332,0.10853029533248786
1278,26,6,0.23076923076923078,20,0,0.0,15.923076923076923,0.10916963930636109
1279,30,3,0.1,27,0,6746.669183890051,11.366666666666667,0.10544115456728752
1280,39,6,0.15384615384615385,33,0,43223.782682610756,25.692307692307693,0.1197319176782748
1281,16,2,0.125,14,0,167.86313047234395,23.0625,0.12540057850235317
1282,12,3,0.25,9,0,14429.8984248149,16.0,0.11780132160791933
1283,59,8,0.13559322033898305,51,0,57909.41168733153,17.050847457627118,0.11755704276312573
1284,14,3,0.21428571428571427,11,0,50224.67267828529,23.142857142857142,0.10155431237123234
1285,15,3,0.2,12,0,0.0,14.466666666666667,0.1145316290203915
1286,19,2,0.10526315789473684,17,0,86577.9632649811,21.68421052631579,0.12694633081160994
1287,11,3,0.2727272727272727,8,0,62.20856831200281,11.636363636363637,0.0702853486557213
1288,34,3,0.08823529411764706,31,0,176363.72734138952,20.058823529411764,0.1139684813037083
1289,18,2,0.1111111111111111,16,0,11875.650841511546,14.333333333333334,0.11621705902135185
1290,21,3,0.14285714285714285,18,0,154446.70280997828,31.761904761904763,0.12627350054200207
1291,25,4,0.16,21,0,11078.149523796053,13.04,0.10354371922255828
1292,30,3,0.1,27,0,9803.30694879553,17.5,0.10140528380454018
1293,42,8,0.19047619047619047,34,0,97498.44439516813,14.5,0.11108733446208169
1294,19,2,0.10526315789473684,17,0,1871.4912616193549,20.789473684210527,0.10558608554075812
1295,32,6,0.1875,26,0,144603.0027089374,16.90625,0.11241294992373371
1296,26,5,0.19230769230769232,21,0,87892.2908118337,15.884615384615385,0.11627550144507845
1297,15,5,0.3333333333333333,10,0,7450.989162219585,25.0,0.1342233369918227
1298,53,9,0.16981132075471697,44,0,483536.3731809722,25.92452830188679,0.11592156464570783
1299,36,9,0.25,27,0,14254.899780303529,15.166666666666666,0.12615291577493234
1300,47,6,0.1276595744680851,41,0,141724.98131092734,18.21276595744681,0.11670147141524961
1301,18,5,0.2777777777777778,13,0,117403.89192736697,14.222222222222221,0.11985628824748246
1302,22,2,0.09090909090909091,20,0,35870.70671751088,21.772727272727273,0.13655996902856518
1303,13,0,0.0,13,0,0.0,16.923076923076923,0.08535495880503151
1304,18,3,0.16666666666666666,15,0,0.0,8.555555555555555,0.10634539377560334
1305,26,8,0.3076923076923077,18,0,253280.61056589012,18.153846153846153,0.09371550844352232
1306,21,5,0.23809523809523808,16,0,76617.911526313,20.285714285714285,0.12725319326495468
1307,13,1,0.07692307692307693,12,0,3770.9818269055736,16.307692307692307,0.1144824716961527
1308,30,5,0.16666666666666666,25,0,57023.45154011498,15.266666666666667,0.1059639718283776
1309,15,3,0.2,12,0,39481.98414299254,39.06666666666667,0.08405999868856458
1310,21,4,0.19047619047619047,17,0,3299.479090575733,13.857142857142858,0.09912643187501528
1311,19,2,0.10526315789473684,17,0,4850.978775681519,9.105263157894736,0.08732573972382669
1312,27,3,0.1111111111111111,24,0,19284.959821773104,38.81481481481482,0.127959255283308
1313,19,6,0.3157894736842105,13,0,288623.43037830654,45.473684210526315,0.12044848008871153
1314,15,2,0.13333333333333333,13,0,27994.853152128155,8.733333333333333,0.07345978016088922
1315,29,3,0.10344827586206896,26,0,219064.99621683414,26.482758620689655,0.11349615776166659
1316,34,4,0.11764705882352941,30,0,1443.365143368768,11.941176470588236,0.10915210876952319
1317,61,11,0.18032786885245902,50,0,75825.61575842585,18.24590163934426,0.10541288536647732
1318,45,4,0.08888888888888889,41,0,150877.76853605313,10.066666666666666,0.08748107577223563
1319,31,2,0.06451612903225806,29,0,67337.23486842627,10.741935483870968,0.09516988025894997
1320,11,1,0.09090909090909091,10,0,167048.7814467475,25.09090909090909,0.07230001464029577
1321,12,2,0.16666666666666666,10,0,0.0,11.25,0.07951909614240095
1322,20,2,0.1,18,0,42336.32631603647,11.35,0.11887576850441002
1323,13,2,0.15384615384615385,11,0,7012.412304222006,12.923076923076923,0.08611852022687609
1324,16,2,0.125,14,0,103078.35526633023,14.5625,0.10379736209006604
1325,25,5,0.2,20,0,313582.19364828675,16.88,0.0815864808333591
1326,21,3,0.14285714285714285,18,0,56827.35378420815,16.857142857142858,0.11339756416594811
1327,28,3,0.10714285714285714,25,0,75590.05487596197,30.857142857142858,0.11755871892437006
1328,28,5,0.17857142857142858,23,0,153761.35302498707,14.071428571428571,0.09970662456274657
1329,35,3,0.08571428571428572,32,0,15728.72358394706,20.771428571428572,0.10992827956851996
1330,13,3,0.23076923076923078,10,0,540234.4207786293,23.923076923076923,0.11550325606481018
1331,29,2,0.06896551724137931,27,0,39042.83735769037,21.24137931034483,0.12107627265779182
1332,12,3,0.25,9,0,13383.475998663946,18.166666666666668,0.11727730533604219
1333,20,3,0.15,17,0,80105.60853340875,12.9,0.10804352378403252
1334,14,2,0.14285714285714285,12,0,0.0,18.285714285714285,0.09276326130962298
1335,23,5,0.21739130434782608,18,0,82.71496257289243,17.869565217391305,0.10744830202734265
1336,16,0,0.0,16,0,67431.23590542315,15.8125,0.0883118298751919
1337,26,5,0.19230769230769232,21,0,92804.69147063684,23.423076923076923,0.09816483337210791
1338,61,13,0.21311475409836064,48,0,32452.21898845718,21.918032786885245,0.1121372452263766
1339,11,1,0.09090909090909091,10,0,5364.534922704422,18.90909090909091,0.11032330184736866
1340,23,8,0.34782608695652173,15,0,0.05797101449275362,13.869565217391305,0.0850142635866745
1341,17,7,0.4117647058823529,10,0,100823.04675817007,12.823529411764707,0.11736693766177791
1342,21,4,0.19047619047619047,17,0,24480.859713691665,13.047619047619047,0.1074968359631433
1343,14,4,0.2857142857142857,10,0,126110.82695329224,22.428571428571427,0.11962303898510553
1344,15,4,0.26666666666666666,11,0,2518.525378892431,37.06666666666667,0.09763949232090875
1345,17,5,0.29411764705882354,12,0,32744.21522488084,19.529411764705884,0.13190026370012684
1346,27,8,0.2962962962962963,19,0,68803.03328858966,13.185185185185185,0.09475852142234979
1347,18,4,0.2222222222222222,14,0,80312.27283583385,38.22222222222222,0.11975296226315536
1348,14,1,0.07142857142857142,13,0,18137.599518946892,20.142857142857142,0.12173510864832134
1349,25,4,0.16,21,0,169730.21762290967,12.12,0.11608338036408077
1350,42,11,0.2619047619047619,31,0,27122.189940588403,10.642857142857142,0.10545023184016657
1351,11,0,0.0,11,0,6890.09445802256,25.272727272727273,0.1161415696855109
1352,17,5,0.29411764705882354,12,0,3158.627142558892,57.94117647058823,0.14683900244285664
1353,39,4,0.10256410256410256,35,0,63705.90072941096,45.76923076923077,0.1164776227996206
1354,28,5,0.17857142857142858,23,0,24341.81329818318,13.392857142857142,0.10149831055232704
1355,20,3,0.15,17,0,109947.09273573043,23.85,0.06479540573608221
1356,35,3,0.08571428571428572,32,0,125401.29070368409,26.942857142857143,0.12082203686448945
1357,54,15,0.2777777777777778,39,0,13773.651596909758,16.5,0.09542949672709149
1358,21,1,0.047619047619047616,20,0,214217.71996678945,28.047619047619047,0.12214545859932774
1359,16,2,0.125,14,0,20635.888241241395,15.3125,0.13462197368652654
1360,24,6,0.25,18,0,78419.28863475936,19.0,0.08416540652022962
1361,19,5,0.2631578947368421,14,0,826.9024267909011,10.947368421052632,0.10479387480991999
1362,21,3,0.14285714285714285,18,0,73479.66691821294,23.333333333333332,0.11089039565533457
1363,15,2,0.13333333333333333,13,0,6102.9333333333325,13.333333333333334,0.11732024888107702
1364,32,5,0.15625,27,0,18064.616559294358,15.15625,0.10694486843288917
1365,13,2,0.15384615384615385,11,0,48768.24938764107,18.76923076923077,0.08448444554865836
1366,19,7,0.3684210526315789,12,0,264651.4843703002,21.42105263157895,0.13061565679415588
1367,18,2,0.1111111111111111,16,0,89443.74435039837,17.444444444444443,0.08609608153760268
1368,13,2,0.15384615384615385,11,0,476.4765790482528,43.76923076923077,0.10803280352068786
1369,38,6,0.15789473684210525,32,0,49219.992581745086,9.052631578947368,0.11081279808301625
1370,15,5,0.3333333333333333,10,0,67698.45533972188,16.4,0.1021018952507482
1371,28,2,0.07142857142857142,26,0,51250.10666898806,34.357142857142854,0.10446522537743964
1372,13,1,0.07692307692307693,12,0,30505.818919193298,14.461538461538462,0.10903129385077709
1373,24,3,0.125,21,0,0.0,9.708333333333334,0.11804677180246533
1374,14,4,0.2857142857142857,10,0,14653.855299234408,23.214285714285715,0.13028621275633925
1375,12,2,0.16666666666666666,10,0,3679.0908103797788,13.666666666666666,0.11643345762062751
1376,11,3,0.2727272727272727,8,0,205318.0786417085,18.363636363636363,0.10709411323136007
1377,15,2,0.13333333333333333,13,0,161963.0564274105,18.933333333333334,0.13772192382100865
1378,22,2,0.09090909090909091,20,0,41756.99287137517,16.40909090909091,0.10415697620742805
1379,15,3,0.2,12,0,150114.67013123672,55.46666666666667,0.1277648244116117
1380,18,2,0.1111111111111111,16,0,80778.39640450479,15.5,0.14588840960630156
1381,12,2,0.16666666666666666,10,0,34261.998370591486,13.666666666666666,0.09132350627807018
1382,17,4,0.23529411764705882,13,0,80250.44219320187,35.64705882352941,0.12848099686372713
1383,12,1,0.08333333333333333,11,0,6720.511395126265,18.583333333333332,0.10416204121484895
1384,14,2,0.14285714285714285,12,0,12460.213254139724,20.0,0.12041956031065217
1385,33,5,0.15151515151515152,28,0,457214.9311870138,42.60606060606061,0.12506405327911427
1386,11,2,0.18181818181818182,9,0,0.0,10.090909090909092,0.10860211219421788
1387,31,7,0.22580645161290322,24,0,125945.84887032643,14.193548387096774,0.10939493385327191
1388,18,1,0.05555555555555555,17,0,4185.860211489644,12.5,0.08415928117271225
1389,25,6,0.24,19,0,286177.00235092314,20.16,0.11929531773175979
1390,18,1,0.05555555555555555,17,0,0.0,14.277777777777779,0.10723590470581897
1391,17,2,0.11764705882352941,15,0,106846.14249671793,25.0,0.1291347260910812
1392,11,0,0.0,11,0,1610.712013068177,23.181818181818183,0.13111371677235892
1393,14,1,0.07142857142857142,13,0,123398.0984638776,21.571428571428573,0.1265409905251576
1394,27,3,0.1111111111111111,24,0,195811.02593154102,25.333333333333332,0.13024780350272083
1395,26,2,0.07692307692307693,24,0,8262.846647069724,12.115384615384615,0.1091842756551405
1396,17,1,0.058823529411764705,16,0,5440.042207171244,18.0,0.09801213510875537
1397,12,2,0.16666666666666666,10,0,21239.39967680608,17.5,0.11260541454569166
1398,18,1,0.05555555555555555,17,0,223.93418006294712,10.055555555555555,0.07829698050339817
1399,30,5,0.16666666666666666,25,0,34923.10140241499,12.266666666666667,0.09945379508368198
1400,13,2,0.15384615384615385,11,0,212481.1167600658,13.538461538461538,0.11499289332202864
1401,11,0,0.0,11,0,0.0,22.272727272727273,0.11818771243276412
1402,26,2,0.07692307692307693,24,0,102273.27411006036,14.576923076923077,0.10768355714755064
1403,102,15,0.14705882352941177,87,0,560675.6813504742,18.137254901960784,0.10212324270705467
1404,14,2,0.14285714285714285,12,0,3269.8785023565733,14.071428571428571,0.11883377721670216
1405,15,2,0.13333333333333333,13,0,448.7889563053825,11.533333333333333,0.11143460358246013
1406,24,4,0.16666666666666666,20,0,1092313.418036021,28.875,0.13509063899865234
1407,14,0,0.0,14,0,191957.67123589502,17.571428571428573,0.10981932261522445
1408,21,4,0.19047619047619047,17,0,8471.840052048126,11.380952380952381,0.11946776090479534
1409,23,1,0.043478260869565216,22,0,212997.7647994469,16.217391304347824,0.13976883339733637
1410,18,10,0.5555555555555556,8,0,0.0,9.944444444444445,0.10794398799473802
1411,20,4,0.2,16,0,3549.23376339155,12.2,0.1298905032788986
1412,19,4,0.21052631578947367,15,0,53215.37837601517,26.210526315789473,0.123893291933859
1413,20,3,0.15,17,0,10119.346494323585,24.8,0.10740922957237131
1414,20,3,0.15,17,0,34860.426896630124,21.2,0.11931030004445806
1415,17,2,0.11764705882352941,15,0,5383.529411764706,9.058823529411764,0.09816175808954487
1416,13,3,0.23076923076923078,10,0,60594.471643033896,69.53846153846153,0.1415167502103634
1417,20,1,0.05,19,0,821.1276459573864,7.4,0.08569544154947777
1418,19,4,0.21052631578947367,15,0,6487.368069174131,13.842105263157896,0.11183198462833632
1419,18,2,0.1111111111111111,16,0,111359.22262052936,13.0,0.10083746577270641
1420,19,3,0.15789473684210525,16,0,100894.36058041816,16.789473684210527,0.11276626016522347
1421,14,3,0.21428571428571427,11,0,3102.2579261387,12.428571428571429,0.10599299778949313
1422,28,6,0.21428571428571427,22,0,3489.324258801294,14.821428571428571,0.11279276206837086
1423,12,3,0.25,9,0,519.9107879135871,37.666666666666664,0.08464225591196729
1424,34,5,0.14705882352941177,29,0,57323.64108839658,16.235294117647058,0.11268353312664917
1425,33,4,0.12121212121212122,29,0,18761.98087493152,17.818181818181817,0.11593483822230809
1426,16,2,0.125,14,0,298905.66045886633,34.5625,0.10890068345280027
1427,16,3,0.1875,13,0,0.0,20.75,0.06921718614951843
1428,22,5,0.22727272727272727,17,0,105788.1037626719,18.09090909090909,0.11051417950962651
1429,17,3,0.17647058823529413,14,0,7100.090631527349,24.823529411764707,0.11874403841272552
1430,15,2,0.13333333333333333,13,0,0.0,12.933333333333334,0.09653851790349952
1431,22,4,0.18181818181818182,18,0,21886.241880320064,13.590909090909092,0.11053310887810829
1432,35,4,0.11428571428571428,31,0,124651.83723980287,28.857142857142858,0.09618520665489909
1433,23,2,0.08695652173913043,21,0,0.0,8.869565217391305,0.08208771848466667
1434,32,6,0.1875,26,0,32050.493773097794,14.34375,0.10471448204326433
1435,38,8,0.21052631578947367,30,0,30577.078411809525,14.31578947368421,0.09588320148037152
1436,10,1,0.1,9,0,44363.43431420479,21.2,0.13560161589013048
1437,15,6,0.4,9,0,95946.36476348065,43.93333333333333,0.12703698583826276
1438,26,7,0.2692307692307692,19,0,49487.720856807624,15.076923076923077,0.11984797809870426
1439,23,3,0.13043478260869565,20,0,278188.9000129428,13.26086956521739,0.0894656339022939
1440,18,3,0.16666666666666666,15,0,0.0,15.666666666666666,0.0962359496259471
1441,14,2,0.14285714285714285,12,0,37352.724363503905,21.5,0.11430170322251486
1442,10,1,0.1,9,0,4215.027960666087,123.7,0.14407897711562767
1443,19,5,0.2631578947368421,14,0,38923.189474259634,12.157894736842104,0.10931962121583141
1444,13,2,0.15384615384615385,11,0,10230.108846163059,22.53846153846154,0.08373516769121149
1445,17,3,0.17647058823529413,14,0,398078.38554784557,27.764705882352942,0.1356756297902455
1446,14,1,0.07142857142857142,13,0,2371470.3817151855,85.35714285714286,0.14133078331165588
1447,22,7,0.3181818181818182,15,0,18772.618327326418,11.363636363636363,0.1117564293968951
1448,26,5,0.19230769230769232,21,0,693024.2317407726,58.30769230769231,0.12791579706742004
1449,22,3,0.13636363636363635,19,0,54312.48046049201,11.909090909090908,0.11963228897880006
1450,14,1,0.07142857142857142,13,0,31929.731986364186,45.57142857142857,0.09124393538165247
1451,24,2,0.08333333333333333,22,0,142998.0246947418,11.833333333333334,0.10049672407744388
1452,30,8,0.26666666666666666,22,0,149150.52718546346,15.6,0.12017846954188857
1453,48,4,0.08333333333333333,44,0,623316.5727681491,29.229166666666668,0.12451955669642277
1454,36,6,0.16666666666666666,30,0,105543.46546629164,42.611111111111114,0.11499652943425288
1455,26,3,0.11538461538461539,23,0,101551.59381723186,11.0,0.11097399146450743
1456,12,3,0.25,9,0,69504.09579613984,18.083333333333332,0.09769397558938751
1457,22,2,0.09090909090909091,20,0,155533.00823852065,18.227272727272727,0.12837979973360011
1458,68,18,0.2647058823529412,50,0,49373.669238003844,20.647058823529413,0.11085642811638693
1459,22,4,0.18181818181818182,18,0,8376.799244990309,18.772727272727273,0.1113897343008368
1460,17,3,0.17647058823529413,14,0,100162.24563500485,27.176470588235293,0.12643253132457505
1461,27,6,0.2222222222222222,21,0,30547.8677067198,21.88888888888889,0.09671016181060772
1462,18,3,0.16666666666666666,15,0,195300.44837973925,17.5,0.11447577269323005
1463,18,5,0.2777777777777778,13,0,12633.52999842737,7.555555555555555,0.10393880081135913
1464,12,2,0.16666666666666666,10,0,20863.59963420777,25.0,0.14994029888663338
1465,15,1,0.06666666666666667,14,0,105040.69547586604,18.2,0.1208776745675135
1466,34,5,0.14705882352941177,29,0,145598.3700045047,13.970588235294118,0.09423238142268017
1467,24,7,0.2916666666666667,17,0,534.4881380623187,15.125,0.10438004591726413
1468,21,1,0.047619047619047616,20,0,66581.59250459926,12.761904761904763,0.11242373018570621
1469,19,3,0.15789473684210525,16,0,7663.252326719394,18.263157894736842,0.10667915330574529
1470,21,1,0.047619047619047616,20,0,1512.1895010959797,24.523809523809526,0.11421914610763506
1471,33,6,0.18181818181818182,27,0,104343.0842048515,17.939393939393938,0.1112318052451478
1472,17,2,0.11764705882352941,15,0,32681.389035883352,15.294117647058824,0.1199744398334684
1473,16,1,0.0625,15,0,5720.125000000002,10.6875,0.10843624275693611
1474,20,6,0.3,14,0,39501.71335779263,18.6,0.10286005175759017
1475,11,1,0.09090909090909091,10,0,0.0,6.909090909090909,0.08963748818686336
1476,23,5,0.21739130434782608,18,0,2251.467936605833,11.91304347826087,0.10042019847237307
1477,12,3,0.25,9,0,26204.028059358505,9.916666666666666,0.10510660411911273
1478,26,4,0.15384615384615385,22,0,214780.9201883135,26.192307692307693,0.1306716161188397
1479,56,8,0.14285714285714285,48,0,96461.9269656672,11.821428571428571,0.1030187337942701
1480,15,3,0.2,12,0,20929.546002786734,16.333333333333332,0.10138146689303039
1481,16,3,0.1875,13,0,7819.462278311875,58.1875,0.13695931631437253
1482,37,8,0.21621621621621623,29,0,14168.530601563734,28.594594594594593,0.10535575889072543
1483,13,2,0.15384615384615385,11,0,94499.46064064813,11.153846153846153,0.133499174619159
1484,20,5,0.25,15,0,11547.70726905672,29.9,0.11251642221893846
1485,27,7,0.25925925925925924,20,0,81568.91967163149,10.88888888888889,0.09943912428075016
1486,34,3,0.08823529411764706,31,0,71112.96437549355,26.61764705882353,0.09019495226081028
1487,25,1,0.04,24,0,13427.163488307875,25.28,0.1148275925989277
1488,15,6,0.4,9,0,78582.56847991065,16.466666666666665,0.11944268512206827
1489,16,2,0.125,14,0,19618.921412402648,22.4375,0.11557993384397106
1490,14,4,0.2857142857142857,10,0,29680.607183464443,12.071428571428571,0.10507683732771098
1491,26,5,0.19230769230769232,21,0,62511.161496858076,27.653846153846153,0.11735559336586038
1492,15,2,0.13333333333333333,13,0,104931.5754988237,41.13333333333333,0.11917182652978489
1493,11,3,0.2727272727272727,8,0,0.0,10.363636363636363,0.11229308786153978
1494,23,2,0.08695652173913043,21,0,267.72835984753794,9.434782608695652,0.09653465458535676
1495,15,2,0.13333333333333333,13,0,35769.153442969015,12.6,0.10201367498422703
1496,26,2,0.07692307692307693,24,0,26018.88072355755,18.03846153846154,0.11281912273039871
1497,14,3,0.21428571428571427,11,0,1.4902721581906937,16.214285714285715,0.13313362043769936
1498,14,1,0.07142857142857142,13,0,59866.77284771808,16.714285714285715,0.10247728894377484
1499,19,3,0.15789473684210525,16,0,796.0386330122718,9.736842105263158,0.10363095650637844
1500,13,0,0.0,13,0,1295029.554515799,30.076923076923077,0.11991563087398607
1501,16,1,0.0625,15,0,32374.00909231481,15.6875,0.12799991487623757
1502,29,6,0.20689655172413793,23,0,37373.01246673513,25.96551724137931,0.11185445274263789
1503,26,7,0.2692307692307692,19,0,78195.32545503599,19.26923076923077,0.13891550245556955
1504,34,7,0.20588235294117646,27,0,23906.344203453944,11.147058823529411,0.09405121063698185
1505,13,2,0.15384615384615385,11,0,5946.5023199128,18.76923076923077,0.1151775177832286
1506,33,4,0.12121212121212122,29,0,23967.193839286538,10.515151515151516,0.09035978368876446
1507,17,2,0.11764705882352941,15,0,60754.55606147883,18.529411764705884,0.11496998464001615
1508,15,4,0.26666666666666666,11,0,152934.21803823978,14.0,0.1278437925102143
1509,19,3,0.15789473684210525,16,0,8916.933414533416,8.947368421052632,0.09341299459640322
1510,17,1,0.058823529411764705,16,0,0.0,13.058823529411764,0.1304473133396958
1511,14,0,0.0,14,0,86515.10972312478,21.142857142857142,0.11375313282541596
1512,13,2,0.15384615384615385,11,0,0.0,10.461538461538462,0.1114123306383079
1513,20,6,0.3,14,0,38180.51538612285,25.65,0.13326829552521954
1514,11,2,0.18181818181818182,9,0,12901.961701673657,12.363636363636363,0.0814579572042593
1515,12,2,0.16666666666666666,10,0,4093.542770213964,46.333333333333336,0.12165249182828315
1516,20,4,0.2,16,0,1798.2542039516793,33.3,0.10726312842084543
1517,11,1,0.09090909090909091,10,0,66462.86589913964,30.363636363636363,0.1296402955176537
1518,12,3,0.25,9,0,38267.87503209756,13.416666666666666,0.12344701844222784
1519,82,13,0.15853658536585366,69,0,929916.9582349478,33.548780487804876,0.1085965526881148
1520,13,3,0.23076923076923078,10,0,1115.3750675987562,10.846153846153847,0.11510876512493287
1521,28,6,0.21428571428571427,22,0,43983.0215967602,14.392857142857142,0.10658519696359084
1522,29,5,0.1724137931034483,24,0,7846.412311412838,7.827586206896552,0.08921653084361783
1523,23,2,0.08695652173913043,21,0,52696.24432123501,16.82608695652174,0.11465151830660143
1524,34,9,0.2647058823529412,25,0,121082.0546842381,26.970588235294116,0.0959706078697249
1525,15,2,0.13333333333333333,13,0,12731.615134632071,12.733333333333333,0.09809800566695807
1526,14,1,0.07142857142857142,13,0,1248533.660548597,31.714285714285715,0.14363915864022994
1527,12,6,0.5,6,0,74186.12726209754,16.083333333333332,0.12185743906724396
1528,12,5,0.4166666666666667,7,0,36331.79660108765,14.0,0.09571536863343903
1529,14,5,0.35714285714285715,9,0,21268.3261994881,10.857142857142858,0.09205904340075062
1530,11,1,0.09090909090909091,10,0,1126.8315100736481,78.63636363636364,0.12118314042596358
1531,31,5,0.16129032258064516,26,0,58979.96640319369,28.387096774193548,0.09430732561221339
1532,49,11,0.22448979591836735,38,0,619411.9386857301,25.653061224489797,0.10020321652794502
1533,20,1,0.05,19,0,106.11064546055059,22.75,0.11930327199145077
1534,34,6,0.17647058823529413,28,0,57714.18058068414,18.147058823529413,0.12585901476477565
1535,60,11,0.18333333333333332,49,0,64716.94421098063,13.966666666666667,0.10866235018583272
1536,16,2,0.125,14,0,80283.0069210363,28.3125,0.11410237211568293
1537,36,10,0.2777777777777778,26,0,171956.1080746409,13.194444444444445,0.09854140129187773
1538,19,2,0.10526315789473684,17,0,528618.166715625,23.36842105263158,0.14344870572723792
1539,41,6,0.14634146341463414,35,0,8062.422779432806,14.634146341463415,0.08724898265934712
1540,13,5,0.38461538461538464,8,0,36130.97237271724,11.0,0.10145657239308328
1541,27,4,0.14814814814814814,23,0,22226.62230085873,13.703703703703704,0.10457787465126983
1542,12,4,0.3333333333333333,8,0,0.0,28.0,0.130765409199896
1543,26,4,0.15384615384615385,22,0,51785.091282472364,21.076923076923077,0.11984608492570614
1544,16,4,0.25,12,0,7165.488423456964,13.9375,0.06256384524170616
1545,14,4,0.2857142857142857,10,0,8844.90931444403,10.571428571428571,0.13143461138924173
1546,18,3,0.16666666666666666,15,0,34221.40399880821,12.5,0.1076265701226103
1547,12,2,0.16666666666666666,10,0,64167.41587988925,21.916666666666668,0.0981469933560723
1548,25,8,0.32,17,0,315363.565893376,44.52,0.12467348707130592
1549,50,5,0.1,45,0,298371.13278600946,16.76,0.102238486880993
1550,15,3,0.2,12,0,13278.10154265969,12.666666666666666,0.08799609301584338
1551,18,3,0.16666666666666666,15,0,464388.3665480315,31.61111111111111,0.12761746129782395
1552,22,2,0.09090909090909091,20,0,0.045454545454545456,9.636363636363637,0.09698925717773993
1553,37,5,0.13513513513513514,32,0,17463.598151626098,13.72972972972973,0.09840072571557962
1554,16,5,0.3125,11,0,0.0909090909090909,13.5625,0.11247641110071158
1555,15,3,0.2,12,0,96261.2009507216,41.46666666666667,0.09207590325381945
1556,46,7,0.15217391304347827,39,0,125297.785388036,30.08695652173913,0.10933655301923606
1557,11,1,0.09090909090909091,10,0,1055532.5624375483,40.27272727272727,0.16056441959764206
1558,18,4,0.2222222222222222,14,0,92633.0368252087,14.666666666666666,0.10929712983260453
1559,12,2,0.16666666666666666,10,0,65125.40045855271,16.833333333333332,0.1415239816092417
1560,11,4,0.36363636363636365,7,0,753.2649027081152,17.0,0.1132737822985932
1561,17,6,0.35294117647058826,11,0,43660.24176913068,14.588235294117647,0.13296680372205352
1562,14,4,0.2857142857142857,10,0,16056.061521521404,23.428571428571427,0.09809984365404137
1563,21,4,0.19047619047619047,17,0,63395.66622998961,32.666666666666664,0.11476172598610106
1564,26,9,0.34615384615384615,17,0,209721.4367644405,28.153846153846153,0.09859344217221139
1565,17,5,0.29411764705882354,12,0,96931.6040643509,14.058823529411764,0.0818265984934701
1566,17,5,0.29411764705882354,12,0,25071.116035029936,9.764705882352942,0.09110993721867244
1567,36,10,0.2777777777777778,26,0,171945.23505249477,27.63888888888889,0.10769574755481688
1568,21,5,0.23809523809523808,16,0,18106.49980653082,11.380952380952381,0.09078912442882377
1569,21,4,0.19047619047619047,17,0,84056.37577994785,23.19047619047619,0.13909518392126904
1570,15,2,0.13333333333333333,13,0,74954.22961689594,22.733333333333334,0.13462651600002856
1571,18,1,0.05555555555555555,17,0,48740.84263124868,31.11111111111111,0.13062070198611306
1572,27,5,0.18518518518518517,22,0,65552.49436967833,18.22222222222222,0.1258094854173352
1573,17,4,0.23529411764705882,13,0,12586.79691756702,40.294117647058826,0.11096793141388064
1574,14,4,0.2857142857142857,10,0,11432.587974782251,9.857142857142858,0.09187858524634461
1575,38,9,0.23684210526315788,29,0,10842.03118853985,13.789473684210526,0.09198705669504462
1576,20,5,0.25,15,0,16203.27987146106,10.5,0.10287276232674289
1577,13,1,0.07692307692307693,12,0,6234.170158123307,13.076923076923077,0.10499800738619808
1578,26,1,0.038461538461538464,25,0,0.0,11.923076923076923,0.10901619900298609
1579,16,1,0.0625,15,0,155453.13294897947,10.5,0.12389259293707006
1580,45,5,0.1111111111111111,40,0,225953.29100364767,17.244444444444444,0.11306059718983232
1581,12,5,0.4166666666666667,7,0,23815.407636119922,13.583333333333334,0.08783523388984633
1582,35,8,0.22857142857142856,27,0,69929.4389173931,34.82857142857143,0.12568571323042832
1583,12,3,0.25,9,0,138678.934510073,16.333333333333332,0.1220913555489667
1584,17,5,0.29411764705882354,12,0,11256.917690467337,33.94117647058823,0.11320985421711703
1585,30,6,0.2,24,0,103790.01284127067,20.1,0.11963130834584582
1586,11,5,0.45454545454545453,6,0,74059.34439633388,30.181818181818183,0.09202522201808533
1587,18,2,0.1111111111111111,16,0,113985.08919173047,14.222222222222221,0.14191647843509297
1588,26,2,0.07692307692307693,24,0,82035.57921919358,30.423076923076923,0.11393209292443826
1589,19,3,0.15789473684210525,16,0,39676.49744569308,10.947368421052632,0.08570910401334894
1590,25,5,0.2,20,0,356209.60306147893,19.16,0.11177474437626714
1591,12,1,0.08333333333333333,11,0,2826.326115346845,10.833333333333334,0.07341207113521882
1592,18,4,0.2222222222222222,14,0,294068.69325695385,19.5,0.09820729926073236
1593,24,3,0.125,21,0,3757.9360606858595,16.041666666666668,0.1044106653651452
1594,27,7,0.25925925925925924,20,0,78430.48189298481,14.592592592592593,0.10767627265016078
1595,14,4,0.2857142857142857,10,0,98148.10321375412,16.571428571428573,0.12238477766094338
1596,14,3,0.21428571428571427,11,0,679844.1246899433,28.857142857142858,0.11103572695846811
1597,27,5,0.18518518518518517,22,0,194.8688212313569,13.0,0.12025280721147118
1598,13,3,0.23076923076923078,10,0,130299.3737590881,21.076923076923077,0.1257121360933327
1599,30,4,0.13333333333333333,26,0,1402.0940759457976,9.666666666666666,0.11440324804818086
1600,15,3,0.2,12,0,5971.330784520312,8.6,0.10944401625992421
1601,22,6,0.2727272727272727,16,0,70821.2304901465,32.36363636363637,0.10735706954926914
1602,15,2,0.13333333333333333,13,0,19312.37105917995,12.6,0.10501060906434909
1603,33,4,0.12121212121212122,29,0,287111.32752935705,20.939393939393938,0.1140459892977749
1604,16,3,0.1875,13,0,281871.946813272,26.6875,0.12186421540790528
1605,33,4,0.12121212121212122,29,0,427667.35187873035,22.242424242424242,0.1315840474018915
1606,14,3,0.21428571428571427,11,0,0.0,13.642857142857142,0.11777140789600339
1607,24,4,0.16666666666666666,20,0,107009.80277184909,27.083333333333332,0.10065647320119446
1608,61,11,0.18032786885245902,50,0,89146.12326581165,14.262295081967213,0.09921974306484063
1609,44,7,0.1590909090909091,37,0,54498.80562467876,10.5,0.11305304899183516
1610,11,0,0.0,11,0,377.28358536122636,12.181818181818182,0.09966572455130422
1611,11,1,0.09090909090909091,10,0,414.56682674502173,8.272727272727273,0.062174407843155415
1612,16,1,0.0625,15,0,6932.7394389476585,16.6875,0.1065566566969311
1613,14,3,0.21428571428571427,11,0,87311.17886372907,16.428571428571427,0.13509499170130534
1614,13,0,0.0,13,0,3170.79513140397,9.307692307692308,0.10800523790493657
1615,19,4,0.21052631578947367,15,0,86752.64692898607,29.68421052631579,0.09831943166140031
1616,13,2,0.15384615384615385,11,0,202841.34092247934,23.53846153846154,0.15325806817489737
1617,21,3,0.14285714285714285,18,0,60628.842231889386,17.761904761904763,0.1168337627424175
1618,13,1,0.07692307692307693,12,0,297795.1223038984,16.46153846153846,0.10744749104708126
1619,38,7,0.18421052631578946,31,0,1486.4012644919012,14.263157894736842,0.11985972971295314
1620,12,1,0.08333333333333333,11,0,175.29855529021458,13.75,0.09954594266653248
1621,12,2,0.16666666666666666,10,0,116045.37880451446,17.083333333333332,0.12338378160949821
1622,17,4,0.23529411764705882,13,0,254050.10171458317,18.41176470588235,0.09486474301123113
1623,11,2,0.18181818181818182,9,0,13101.887882976751,21.454545454545453,0.1236865520414696
1624,13,2,0.15384615384615385,11,0,0.0,7.6923076923076925,0.07594926758024992
1625,26,6,0.23076923076923078,20,0,8805.719667457543,13.153846153846153,0.09061369903919725
1626,25,5,0.2,20,0,8929.18148725058,27.6,0.100823681818294
1627,11,4,0.36363636363636365,7,0,42234.74977787619,46.36363636363637,0.14255065175118176
1628,32,7,0.21875,25,0,294649.04773219913,35.75,0.11263119697767701
1629,14,3,0.21428571428571427,11,0,68.62632590633224,18.214285714285715,0.1096649896001588
1630,22,3,0.13636363636363635,19,0,1626.7914902457749,17.636363636363637,0.10636416928023244
1631,22,5,0.22727272727272727,17,0,60923.0782921918,14.590909090909092,0.10072567469017119
1632,22,3,0.13636363636363635,19,0,22408.05640706538,28.40909090909091,0.09062851759495434
1633,27,6,0.2222222222222222,21,0,1966.4628066245798,12.407407407407407,0.109503443065806
1634,37,12,0.32432432432432434,25,0,15775.36162913858,20.135135135135137,0.09489904209827835
1635,25,9,0.36,16,0,46855.091906519236,21.44,0.11190972757483804
1636,19,4,0.21052631578947367,15,0,13.135507421578044,12.157894736842104,0.1108439927760221
1637,14,3,0.21428571428571427,11,0,345309.82866291364,21.214285714285715,0.1419437728638063
1638,16,1,0.0625,15,0,27267.731632267038,18.25,0.120033059806533
1639,13,4,0.3076923076923077,9,0,124033.57617415827,19.076923076923077,0.09184879988485622
1640,31,8,0.25806451612903225,23,0,23346.110249040943,10.612903225806452,0.11046316065508924
1641,28,3,0.10714285714285714,25,0,875.4448645335034,14.714285714285714,0.09024481966356775
1642,17,4,0.23529411764705882,13,0,55266.52633929824,16.647058823529413,0.10019135039803771
1643,13,2,0.15384615384615385,11,0,0.15897435897435896,11.153846153846153,0.08918362414149197
1644,22,6,0.2727272727272727,16,0,226449.30775774346,20.227272727272727,0.1260768787270071
1645,16,2,0.125,14,0,135545.08560103242,24.375,0.13398787514373078
1646,15,2,0.13333333333333333,13,0,135065.50173408564,35.93333333333333,0.09642543825265665
1647,13,1,0.07692307692307693,12,0,0.15384615384615385,12.76923076923077,0.097563250685232
1648,29,5,0.1724137931034483,24,0,11307.116852418198,14.10344827586207,0.10113958861494081
1649,29,2,0.06896551724137931,27,0,303549.2028724506,19.586206896551722,0.11983358628626942
1650,15,3,0.2,12,0,964971.0702048261,48.666666666666664,0.12362143670245175
1651,36,8,0.2222222222222222,28,0,91896.00203898182,17.083333333333332,0.10341935734141669
1652,17,4,0.23529411764705882,13,0,141081.16513097534,14.823529411764707,0.10668548197695354
1653,17,1,0.058823529411764705,16,0,146925.68710699512,15.470588235294118,0.10570179394802888
1654,15,1,0.06666666666666667,14,0,4108.40754009153,16.6,0.1255534875943287
1655,22,6,0.2727272727272727,16,0,3710.045958063757,14.454545454545455,0.11924883931703013
1656,14,3,0.21428571428571427,11,0,39261.63348055242,21.428571428571427,0.12276564698509622
1657,58,7,0.1206896551724138,51,0,65135.52990263282,14.120689655172415,0.1115615531553544
1658,15,2,0.13333333333333333,13,0,7179.714583042188,36.666666666666664,0.10323035398799515
1659,11,3,0.2727272727272727,8,0,0.0,5.545454545454546,0.07262162147816355
1660,16,2,0.125,14,0,149534.31890403244,18.875,0.10129392318303815
1661,25,6,0.24,19,0,254381.93935211853,20.24,0.109364879514313
1662,22,3,0.13636363636363635,19,0,68759.50716515759,18.772727272727273,0.08853945399389762
1663,19,3,0.15789473684210525,16,0,17718.53258054266,18.526315789473685,0.11120828205692072
1664,18,3,0.16666666666666666,15,0,14428.652528560819,12.166666666666666,0.10238170075160775
1665,47,2,0.0425531914893617,45,0,67875.84431399267,16.51063829787234,0.12616163435675526
1666,18,4,0.2222222222222222,14,0,64374.33294581578,16.444444444444443,0.1004495711393742
1667,11,2,0.18181818181818182,9,0,265396.67674696207,17.636363636363637,0.13300542849777677
1668,24,3,0.125,21,0,92441.22153090585,16.208333333333332,0.10535708892440288
1669,21,3,0.14285714285714285,18,0,26410.611826681565,15.047619047619047,0.12244856728899116
1670,11,3,0.2727272727272727,8,0,0.0,19.818181818181817,0.09549576933752445
1671,10,2,0.2,8,0,0.0,17.9,0.11085442439131836
1672,26,4,0.15384615384615385,22,0,0.30769230769230765,13.23076923076923,0.0985315527645377
1673,19,3,0.15789473684210525,16,0,797506.4996613578,33.526315789473685,0.11432565387412118
1674,12,1,0.08333333333333333,11,0,0.06666666666666667,9.5,0.07783055513362784
1675,13,1,0.07692307692307693,12,0,97245.65054767914,12.384615384615385,0.09537156810096578
1676,40,8,0.2,32,0,43439.9634301141,18.05,0.10241718598520441
1677,17,4,0.23529411764705882,13,0,2.166666666666667,11.411764705882353,0.08265193534953046
1678,15,1,0.06666666666666667,14,0,110790.32271692209,18.2,0.13623957559551775
1679,12,3,0.25,9,0,16012.097523415156,48.75,0.1207863442178837
1680,27,4,0.14814814814814814,23,0,229369.62659567108,15.037037037037036,0.10050280646602491
1681,12,2,0.16666666666666666,10,0,117388.26006956062,14.666666666666666,0.09009072064473221
1682,21,5,0.23809523809523808,16,0,19648.00491687088,15.142857142857142,0.12834527313144112
1683,26,6,0.23076923076923078,20,0,16947.204551932624,14.0,0.09562790174916748
1684,15,2,0.13333333333333333,13,0,77764.05579731916,17.6,0.11892249475658129
1685,16,2,0.125,14,0,31774.82367217217,11.125,0.08974185868956615
1686,13,2,0.15384615384615385,11,0,49169.12531179156,24.153846153846153,0.1387191901404701
1687,25,4,0.16,21,0,80090.29858899671,19.12,0.08762558265303477
1688,24,7,0.2916666666666667,17,0,37598.54095192707,33.75,0.14290609085371225
1689,22,6,0.2727272727272727,16,0,13503.257153516617,12.409090909090908,0.09648997034893231
1690,18,1,0.05555555555555555,17,0,154385.37864015304,25.61111111111111,0.1377685709263482
1691,19,5,0.2631578947368421,14,0,282.9554227259041,15.0,0.10597114684937689
1692,15,3,0.2,12,0,311226.1139417384,36.93333333333333,0.10781674698029148
1693,17,1,0.058823529411764705,16,0,300396.0248205186,53.11764705882353,0.11514495700738275
1694,13,4,0.3076923076923077,9,0,111116.44656094414,13.307692307692308,0.11440749515447403
1695,36,2,0.05555555555555555,34,0,12344.51124296145,14.88888888888889,0.10579567817969299
1696,14,2,0.14285714285714285,12,0,127442.55090261778,11.928571428571429,0.10058741852589193
1697,43,8,0.18604651162790697,35,0,29037.650561243816,15.209302325581396,0.12079490089225728
1698,13,0,0.0,13,0,83961.65894795049,12.846153846153847,0.10692118126769544
1699,12,5,0.4166666666666667,7,0,71837.29379646444,24.0,0.13026159148873326
1700,18,3,0.16666666666666666,15,0,22.599465329943353,11.333333333333334,0.10665676607944435
1701,29,4,0.13793103448275862,25,0,52834.904944216505,12.344827586206897,0.10939077361993184
1702,22,2,0.09090909090909091,20,0,38657.21910017179,16.045454545454547,0.11799173868598248
1703,17,5,0.29411764705882354,12,0,48290.773780299525,14.176470588235293,0.1341602458185838
1704,24,2,0.08333333333333333,22,0,4177.88753265604,14.0,0.1281088462737318
1705,29,4,0.13793103448275862,25,0,74350.67358984072,17.448275862068964,0.13187326718464545
1706,35,4,0.11428571428571428,31,0,108785.25718587427,25.542857142857144,0.11951548653989405
1707,87,11,0.12643678160919541,76,0,486925.1719413225,22.413793103448278,0.1157077143294161
1708,87,14,0.16091954022988506,73,0,1001367.926031601,32.52873563218391,0.1333528255348054
1709,12,2,0.16666666666666666,10,0,66770.73381399707,18.583333333333332,0.13726956890141925
1710,18,5,0.2777777777777778,13,0,55305.480889229424,11.277777777777779,0.09574485634326331
1711,20,4,0.2,16,0,83532.0811658009,21.15,0.12534251605623062
1712,17,2,0.11764705882352941,15,0,449.1853238075349,10.823529411764707,0.0938080591188684
1713,17,2,0.11764705882352941,15,0,245037.87707446175,15.294117647058824,0.13180112260403745
1714,20,6,0.3,14,0,11691.358512328914,9.9,0.10059338436346003
1715,16,2,0.125,14,0,12818.863034912645,16.1875,0.11257506192864342
1716,12,2,0.16666666666666666,10,0,21954.212872736378,13.583333333333334,0.1364715565667324
1717,13,2,0.15384615384615385,11,0,242209.85526718313,20.846153846153847,0.1286691693909172
1718,27,7,0.25925925925925924,20,0,382898.97457029537,36.333333333333336,0.11365816984877647
1719,28,4,0.14285714285714285,24,0,86426.23227159167,26.607142857142858,0.12697925020259215
1720,13,3,0.23076923076923078,10,0,3701.748209913156,42.92307692307692,0.12322951984798194
1721,14,3,0.21428571428571427,11,0,45754.0,15.928571428571429,0.10161423689858881
1722,11,1,0.09090909090909091,10,0,91.34296076732556,10.272727272727273,0.0948567067076322
1723,33,5,0.15151515151515152,28,0,233696.6353726031,26.181818181818183,0.13116855432136956
1724,23,4,0.17391304347826086,19,0,47268.42417927669,23.82608695652174,0.12252236177505758
1725,23,5,0.21739130434782608,18,0,90149.93512546159,33.30434782608695,0.11391944543743153
1726,18,2,0.1111111111111111,16,0,3.0530544505280983,17.555555555555557,0.10966268442553437
1727,32,10,0.3125,22,0,9774.627926959625,11.28125,0.10942608463572503
1728,12,1,0.08333333333333333,11,0,46255.661878440595,26.5,0.13262754293068654
1729,18,4,0.2222222222222222,14,0,18627.90242847601,17.27777777777778,0.11486525942194446
1730,18,1,0.05555555555555555,17,0,63579.09212834225,17.166666666666668,0.10581231239789547
1731,12,2,0.16666666666666666,10,0,228576.65900591624,14.583333333333334,0.11361371763726243
1732,11,1,0.09090909090909091,10,0,11570.520548467408,17.727272727272727,0.13780151889645037
1733,29,5,0.1724137931034483,24,0,9051.980291251015,14.310344827586206,0.10690822743723635
1734,21,1,0.047619047619047616,20,0,25615.927523035618,12.904761904761905,0.09792103684088203
1735,25,7,0.28,18,0,16243.798702049851,11.44,0.1158820718405141
1736,14,2,0.14285714285714285,12,0,106089.3799886234,12.857142857142858,0.1046716901449796
1737,46,14,0.30434782608695654,32,0,4702.106703939646,17.82608695652174,0.11868648947615063
1738,15,3,0.2,12,0,236768.6987904072,20.533333333333335,0.09303248625017428
1739,14,2,0.14285714285714285,12,0,116.01106605767725,10.5,0.0936662636709804
1740,12,1,0.08333333333333333,11,0,13820.939065981183,15.083333333333334,0.14045030459764316
1741,27,1,0.037037037037037035,26,0,39932.86513014263,15.407407407407407,0.10168791694841929
1742,11,3,0.2727272727272727,8,0,14425.226357292197,23.545454545454547,0.15990702166804158
1743,15,2,0.13333333333333333,13,0,59937.861662849165,17.266666666666666,0.10117735070036711
1744,28,7,0.25,21,0,3578.7907790367494,13.857142857142858,0.09862956013234413
1745,12,1,0.08333333333333333,11,0,0.0,10.333333333333334,0.09899875925161322
1746,15,1,0.06666666666666667,14,0,41004.19054255538,37.733333333333334,0.11954872720445922
1747,12,1,0.08333333333333333,11,0,57826.856331522016,21.166666666666668,0.11950890193231024
1748,14,1,0.07142857142857142,13,0,0.0,17.285714285714285,0.12773676048042354
1749,12,2,0.16666666666666666,10,0,0.3333333333333333,7.5,0.07235524417764974
1750,14,0,0.0,14,0,1904.824197376874,14.857142857142858,0.09469821064327857
1751,13,0,0.0,13,0,351398.2098277115,19.153846153846153,0.11285337663187132
1752,21,2,0.09523809523809523,19,0,118088.63987393575,13.476190476190476,0.0896357508578441
1753,35,8,0.22857142857142856,27,0,38983.78123369453,15.6,0.11064301648120038
1754,18,3,0.16666666666666666,15,0,189949.64086758782,17.38888888888889,0.11254712465032513
1755,13,3,0.23076923076923078,10,0,2279.619156584829,8.692307692307692,0.09239577143877538
1756,12,6,0.5,6,0,35374.40321423685,66.91666666666667,0.109282932784949
1757,23,4,0.17391304347826086,19,0,210481.59084594474,16.217391304347824,0.10554322011154395
1758,23,7,0.30434782608695654,16,0,12903.89812842121,7.913043478260869,0.09385369328720952
1759,23,1,0.043478260869565216,22,0,0.0,9.869565217391305,0.08753709105596762
1760,18,1,0.05555555555555555,17,0,6860.803433585299,15.0,0.0934959936845971
1761,22,4,0.18181818181818182,18,0,114442.73040372934,21.363636363636363,0.1183781337243976
1762,22,5,0.22727272727272727,17,0,180348.19478372918,23.0,0.12956336422366335
1763,26,5,0.19230769230769232,21,0,26378.880988362303,10.576923076923077,0.08997681103653675
1764,12,2,0.16666666666666666,10,0,40790.09812058052,30.416666666666668,0.13840277593176847
1765,25,6,0.24,19,0,157187.596810761,15.6,0.09746609768482031
1766,17,2,0.11764705882352941,15,0,1234740.3662573348,69.70588235294117,0.11443288385249313
1767,33,6,0.18181818181818182,27,0,23529.710813122423,13.757575757575758,0.10510634278056118
1768,54,14,0.25925925925925924,40,0,89133.6274395935,12.851851851851851,0.11188480479728209
1769,30,8,0.26666666666666666,22,0,48786.8290801899,27.5,0.09872403809034593
1770,24,8,0.3333333333333333,16,0,4085.3426182482194,25.583333333333332,0.10756029573749339
1771,18,4,0.2222222222222222,14,0,4673.328321913754,11.666666666666666,0.10054371548005073
1772,36,5,0.1388888888888889,31,0,30845.480566391107,21.305555555555557,0.10043773370258138
1773,39,7,0.1794871794871795,32,0,20106.915975031952,13.384615384615385,0.10345987040377667
1774,20,1,0.05,19,0,4391.734665465499,10.0,0.11071075684386848
1775,10,2,0.2,8,0,15030.751203679527,46.0,0.11496039077034954
1776,42,6,0.14285714285714285,36,0,342480.7900098129,21.738095238095237,0.1083149393049102
1777,11,1,0.09090909090909091,10,0,35.23630224621581,16.454545454545453,0.13045727588753986
1778,48,8,0.16666666666666666,40,0,238713.86106518327,28.979166666666668,0.1135174408069441
1779,47,9,0.19148936170212766,38,0,27972.917024641105,14.446808510638299,0.10322376419835533
1780,27,4,0.14814814814814814,23,0,54.2106976343547,9.88888888888889,0.12255657481561334
1781,18,3,0.16666666666666666,15,0,303585.3562156547,27.555555555555557,0.12707362966019103
1782,30,7,0.23333333333333334,23,0,28419.487441519068,14.833333333333334,0.11806179120085415
1783,25,1,0.04,24,0,20166.102680755608,14.48,0.10317283938267273
1784,11,0,0.0,11,0,0.0,7.545454545454546,0.09377682999457539
1785,18,2,0.1111111111111111,16,0,348462.0646338772,24.38888888888889,0.12322689063752364
1786,20,3,0.15,17,0,86285.45402854777,33.1,0.10586957506104215
1787,12,1,0.08333333333333333,11,0,0.0,10.0,0.11087638988661726
1788,12,0,0.0,12,0,128.00068092600355,10.25,0.10544288676602499
1789,12,0,0.0,12,0,20169.580014000534,44.666666666666664,0.12001227503468997
1790,11,4,0.36363636363636365,7,0,49914.54545454548,8.181818181818182,0.09639911539234736
1791,14,3,0.21428571428571427,11,0,4373.593100847998,16.714285714285715,0.14283809764784003
1792,25,4,0.16,21,0,16453.37127661717,19.48,0.1206044231493221
1793,11,2,0.18181818181818182,9,0,46416.956461238246,12.0,0.10040429301851557
1794,12,3,0.25,9,0,9966.96106684881,17.916666666666668,0.08947286891912931
1795,24,6,0.25,18,0,227375.7624399839,21.625,0.1066928772664945
1796,13,2,0.15384615384615385,11,0,9315.215300136992,43.07692307692308,0.07321197278752062
1797,43,7,0.16279069767441862,36,0,494251.98898971075,19.162790697674417,0.11339250322786082
1798,14,2,0.14285714285714285,12,0,29976.207484509265,15.214285714285714,0.10858289463954905
1799,25,5,0.2,20,0,216056.72059883559,14.72,0.11331774586455856
1800,23,4,0.17391304347826086,19,0,16042.570238196899,17.52173913043478,0.11224345915007103
1801,41,13,0.3170731707317073,28,0,9305.827435057681,18.536585365853657,0.11147804710901309
1802,11,2,0.18181818181818182,9,0,240633.0989298406,27.727272727272727,0.11925119614423398
1803,11,0,0.0,11,0,7522.188412774686,23.181818181818183,0.12124784480079126
1804,29,4,0.13793103448275862,25,0,42393.242294815966,17.379310344827587,0.11509069806322951
1805,18,1,0.05555555555555555,17,0,50457.699294507984,19.88888888888889,0.11356801386136722
1806,14,1,0.07142857142857142,13,0,68019.86172389046,15.428571428571429,0.11021004786620334
1807,27,4,0.14814814814814814,23,0,380.8736016937862,14.11111111111111,0.11510663090790126
1808,11,3,0.2727272727272727,8,0,38657.805605629794,27.454545454545453,0.07837501994017174
1809,21,5,0.23809523809523808,16,0,21461.425601968458,15.428571428571429,0.10297459517860383
1810,20,4,0.2,16,0,21336.6017245464,11.6,0.10251682376527656
1811,14,2,0.14285714285714285,12,0,41485.113435429295,10.214285714285714,0.07833093098054393
1812,11,2,0.18181818181818182,9,0,33758.64833479261,16.0,0.12263374369942331
1813,18,3,0.16666666666666666,15,0,20050.845275865766,18.27777777777778,0.11593943669438082
1814,19,4,0.21052631578947367,15,0,14920.613180982544,10.789473684210526,0.11329540598211157
1815,35,10,0.2857142857142857,25,0,156521.43767324122,24.0,0.1115918003969892
1816,21,5,0.23809523809523808,16,0,18624.86681458536,11.333333333333334,0.10708014596393489
1817,28,2,0.07142857142857142,26,0,150380.76356014237,17.25,0.108501130461655
1818,14,2,0.14285714285714285,12,0,109927.56310548351,21.428571428571427,0.12312351231955944
1819,36,5,0.1388888888888889,31,0,482107.79711508774,16.194444444444443,0.09067876915149663
1820,19,1,0.05263157894736842,18,0,23534.156181773713,14.842105263157896,0.11979184379236886
1821,18,2,0.1111111111111111,16,0,53059.889132648386,18.666666666666668,0.11923971197510023
1822,24,4,0.16666666666666666,20,0,13575.023474459966,16.875,0.13166640687085343
1823,17,1,0.058823529411764705,16,0,52773.735368949885,34.8235294117647,0.11868707870548709
1824,82,11,0.13414634146341464,71,0,338217.92194767576,16.524390243902438,0.10306040133096937
1825,11,1,0.09090909090909091,10,0,169770.07702116005,49.45454545454545,0.11778328999303128
1826,16,3,0.1875,13,0,256099.91892554503,18.25,0.08560476471094106
1827,29,4,0.13793103448275862,25,0,56862.978141479754,16.655172413793103,0.11466077821889045
1828,23,8,0.34782608695652173,15,0,253932.10904216883,13.0,0.11402429500017996
1829,17,4,0.23529411764705882,13,0,2015.635681900234,18.176470588235293,0.12305607807033363
1830,43,12,0.27906976744186046,31,0,751992.8490499608,40.04651162790697,0.10830023248383297
1831,30,7,0.23333333333333334,23,0,606.1336514133584,24.5,0.08521415976626905
1832,20,3,0.15,17,0,55394.3340368279,13.15,0.1112681936565725
1833,24,1,0.041666666666666664,23,0,14797.676898108684,15.75,0.1030645776181532
1834,31,3,0.0967741935483871,28,0,208136.1004067482,14.387096774193548,0.11512884307096076
1835,25,5,0.2,20,0,47993.25607395225,20.84,0.11044576319903954
1836,13,0,0.0,13,0,42431.132957276546,16.846153846153847,0.1084048920241837
1837,29,7,0.2413793103448276,22,0,3714.3025624053357,13.862068965517242,0.10819504810510185
1838,14,2,0.14285714285714285,12,0,172616.34874958397,28.214285714285715,0.12661736465876877
1839,27,5,0.18518518518518517,22,0,93568.75292094938,25.22222222222222,0.12186005485265185
1840,26,2,0.07692307692307693,24,0,0.6153846153846154,12.461538461538462,0.09811198545267444
1841,17,2,0.11764705882352941,15,0,14313.667669660163,13.117647058823529,0.11510043506672989
1842,48,7,0.14583333333333334,41,0,255155.43842721405,23.8125,0.11746764075160641
1843,12,1,0.08333333333333333,11,0,80783.8667261706,11.166666666666666,0.06877903777762925
1844,36,8,0.2222222222222222,28,0,191066.5914884027,18.88888888888889,0.13274671759088644
1845,29,10,0.3448275862068966,19,0,380526.6056712421,20.620689655172413,0.11179044278066391
1846,27,8,0.2962962962962963,19,0,30713.015904300246,40.03703703703704,0.12600772340480498
1847,19,2,0.10526315789473684,17,0,912473.9571074138,22.526315789473685,0.11647761107465997
1848,30,3,0.1,27,0,669506.4321139614,36.86666666666667,0.12742241330271806
1849,11,1,0.09090909090909091,10,0,41124.8093748897,21.636363636363637,0.11575686648101638
1850,14,1,0.07142857142857142,13,0,30695.520296084425,20.285714285714285,0.13002565328954158
1851,16,1,0.0625,15,0,501700.064591035,16.625,0.10933576361686104
1852,20,7,0.35,13,0,12.775580345966233,12.4,0.0989554718558817
1853,12,3,0.25,9,0,36288.23292791766,23.583333333333332,0.15875772126100876
1854,14,0,0.0,14,0,8627.235148139638,16.285714285714285,0.10287252215390359
1855,32,6,0.1875,26,0,177831.3657065631,27.53125,0.11457720341768558
1856,14,4,0.2857142857142857,10,0,7524.958901452158,18.142857142857142,0.14008018859250695
1857,58,7,0.1206896551724138,51,0,198416.5767340538,24.43103448275862,0.1174216523580388
1858,16,3,0.1875,13,0,0.0,10.125,0.0699578021191974
1859,16,5,0.3125,11,0,125964.8898791035,9.875,0.11209498457261777
1860,12,3,0.25,9,0,72579.14627799457,11.833333333333334,0.13488828418850252
1861,26,5,0.19230769230769232,21,0,5079.570586341124,11.846153846153847,0.09454405096840673
1862,17,0,0.0,17,0,24313.596633406112,16.647058823529413,0.09963757761476413
1863,28,3,0.10714285714285714,25,0,69617.49467394825,17.178571428571427,0.11385462358850489
1864,12,2,0.16666666666666666,10,0,21387.576557542397,19.166666666666668,0.11557777841588945
1865,31,6,0.1935483870967742,25,0,353009.2111096394,56.41935483870968,0.1092623463440856
1866,54,8,0.14814814814814814,46,0,63303.16790273686,13.574074074074074,0.1072645323770641
1867,15,1,0.06666666666666667,14,0,16159.020627464306,10.4,0.10708378877186811
1868,11,2,0.18181818181818182,9,0,20820.4203947851,9.090909090909092,0.06705603254923348
1869,14,3,0.21428571428571427,11,0,243243.55641164578,63.714285714285715,0.15538276302854892
1870,16,5,0.3125,11,0,7792.9154424147855,12.75,0.07272931277088585
1871,17,4,0.23529411764705882,13,0,300738.38848736987,35.294117647058826,0.11633342745010034
1872,18,4,0.2222222222222222,14,0,8611.720947758375,17.72222222222222,0.11275043889305267
1873,25,2,0.08,23,0,5969.850891090767,31.24,0.11490404277888924
1874,18,4,0.2222222222222222,14,0,77034.70047466505,17.11111111111111,0.12336935794527006
1875,13,4,0.3076923076923077,9,0,0.0,19.76923076923077,0.13218340399256642
1876,13,2,0.15384615384615385,11,0,307144.22186046216,44.76923076923077,0.1133399284524435
1877,12,2,0.16666666666666666,10,0,20466.997687880186,15.25,0.10941327667705998
1878,56,14,0.25,42,0,668436.9133934269,21.946428571428573,0.11220903202950029
1879,18,7,0.3888888888888889,11,0,35590.346477662824,17.11111111111111,0.08866649641428982
1880,12,0,0.0,12,0,2148.898024016218,7.083333333333333,0.09255870739793721
1881,13,6,0.46153846153846156,7,0,4797.496201629076,18.23076923076923,0.10742569636398179
1882,12,3,0.25,9,0,63720.75462553459,19.25,0.10296953898219452
1883,11,3,0.2727272727272727,8,0,12397.190160625563,33.72727272727273,0.13940152192947527
1884,18,3,0.16666666666666666,15,0,38.0163473017795,11.666666666666666,0.11606919409366911
1885,12,2,0.16666666666666666,10,0,0.0,19.25,0.09827190310841209
1886,13,1,0.07692307692307693,12,0,8700.174541515287,25.23076923076923,0.12132729235435168
1887,24,8,0.3333333333333333,16,0,156204.8159239116,12.125,0.11364845764561397
1888,23,1,0.043478260869565216,22,0,139975.52245193545,22.47826086956522,0.1365916356101549
1889,43,4,0.09302325581395349,39,0,55031.51504655888,26.767441860465116,0.12738387089649478
1890,42,8,0.19047619047619047,34,0,58025.67519937271,15.166666666666666,0.12656168260482595
1891,14,3,0.21428571428571427,11,0,0.0,9.642857142857142,0.09292695249501914
1892,21,3,0.14285714285714285,18,0,9244.453361117212,15.619047619047619,0.1050600113958023
1893,11,3,0.2727272727272727,8,0,468695.2267112388,58.63636363636363,0.09279392217933925
1894,27,5,0.18518518518518517,22,0,29730.767296101974,10.592592592592593,0.10366048692125657
1895,10,2,0.2,8,0,0.0,8.6,0.09340778056059058
1896,22,4,0.18181818181818182,18,0,123084.58934183727,11.818181818181818,0.10337920505914022
1897,14,1,0.07142857142857142,13,0,164771.15668618184,27.214285714285715,0.15009849759412888
1898,50,15,0.3,35,0,54245.92664930245,14.82,0.10547964137921514
1899,25,9,0.36,16,0,7546.301961274295,11.36,0.11439007338517306
1900,18,6,0.3333333333333333,12,0,65505.76147449648,13.777777777777779,0.11669692449306007
1901,12,2,0.16666666666666666,10,0,7627.0,5.166666666666667,0.0859090379366813
1902,69,14,0.2028985507246377,55,0,53690.077924087505,20.18840579710145,0.09800311311875734
1903,15,2,0.13333333333333333,13,0,18798.793728843317,27.933333333333334,0.09133336353719149
1904,26,6,0.23076923076923078,20,0,28077.963783529445,12.73076923076923,0.08735876900813107
1905,14,3,0.21428571428571427,11,0,13237.441019168085,13.714285714285714,0.11163178894040647
1906,12,2,0.16666666666666666,10,0,49439.44914520811,16.5,0.12105963960980813
1907,15,3,0.2,12,0,8872.68679810778,13.2,0.10052861681936412
1908,21,7,0.3333333333333333,14,0,70.42134231264119,8.904761904761905,0.10750651513446567
1909,45,14,0.3111111111111111,31,0,10197.139119166055,14.644444444444444,0.11153686966188228
1910,22,6,0.2727272727272727,16,0,48420.75562583907,15.454545454545455,0.11053666272962738
1911,22,3,0.13636363636363635,19,0,59661.68024095627,17.045454545454547,0.12360748834229854
1912,21,3,0.14285714285714285,18,0,399898.4705043317,22.38095238095238,0.1009249411933135
1913,44,7,0.1590909090909091,37,0,85183.63026581226,15.090909090909092,0.12017951507934774
1914,11,3,0.2727272727272727,8,0,0.0,17.181818181818183,0.13406529529879768
1915,15,2,0.13333333333333333,13,0,1883.5271814430214,18.466666666666665,0.102170785070212
1916,33,6,0.18181818181818182,27,0,85318.01618990624,16.09090909090909,0.1081863267983056
1917,19,5,0.2631578947368421,14,0,150105.81726683467,13.368421052631579,0.10652503810793122
1918,30,6,0.2,24,0,7658.2481690035875,14.633333333333333,0.10138999573384758
1919,17,2,0.11764705882352941,15,0,180711.17904990423,24.58823529411765,0.08492613243423965
1920,18,2,0.1111111111111111,16,0,333636.19489486323,15.722222222222221,0.11715974944388909
1921,21,4,0.19047619047619047,17,0,46134.54113338595,11.952380952380953,0.0770041281863181
1922,11,1,0.09090909090909091,10,0,1457.4391953761774,15.181818181818182,0.10449553706165969
1923,17,3,0.17647058823529413,14,0,105030.11071982898,19.764705882352942,0.1310008198966114
1924,12,1,0.08333333333333333,11,0,2385.138888888889,14.25,0.07387448674773091
1925,11,3,0.2727272727272727,8,0,0.0,21.181818181818183,0.12163592731966087
1926,16,3,0.1875,13,0,112.49501930453583,9.9375,0.11069096119098476
1927,42,11,0.2619047619047619,31,0,1815721.020587829,21.88095238095238,0.10042782785207553
1928,15,2,0.13333333333333333,13,0,46483.69133192169,14.933333333333334,0.12543026490714979
1929,21,1,0.047619047619047616,20,0,137060.25514014545,13.857142857142858,0.09536869304945028
1930,52,10,0.19230769230769232,42,0,615705.9004938024,18.75,0.1315351931958763
1931,11,1,0.09090909090909091,10,0,0.0,9.090909090909092,0.07236604058421228
1932,12,1,0.08333333333333333,11,0,110510.61835499395,24.166666666666668,0.12400989833940845
1933,14,2,0.14285714285714285,12,0,31207.05583877906,13.571428571428571,0.10260859538298121
1934,21,4,0.19047619047619047,17,0,9378.104427753313,10.19047619047619,0.11751236035861908
1935,11,0,0.0,11,0,27235.036320199677,19.727272727272727,0.1297174240649036
1936,31,5,0.16129032258064516,26,0,36546.9781596829,20.0,0.1127251638953989
1937,19,3,0.15789473684210525,16,0,140026.83990772572,16.842105263157894,0.11098672766941152
1938,32,11,0.34375,21,0,27223.119584655356,16.34375,0.11498145149158297
1939,27,4,0.14814814814814814,23,0,156658.3957753208,9.037037037037036,0.07398426652993909
1940,17,1,0.058823529411764705,16,0,9178.828021880487,10.411764705882353,0.10148989959528977
1941,18,4,0.2222222222222222,14,0,240136.82679952774,15.5,0.11302764832055012
1942,13,4,0.3076923076923077,9,0,60698.74263372713,21.307692307692307,0.11703853532054928
1943,21,3,0.14285714285714285,18,0,24572.331439322134,19.61904761904762,0.11942223702237985
1944,29,6,0.20689655172413793,23,0,1610.5705728793384,14.344827586206897,0.08480343121763309
1945,16,1,0.0625,15,0,59685.7096214502,11.8125,0.11207080294277949
1946,24,3,0.125,21,0,274655.5017030393,15.625,0.11713107326942956
1947,16,0,0.0,16,0,434352.4909235253,29.1875,0.13618431258183145
1948,61,10,0.16393442622950818,51,0,485393.59728130465,17.40983606557377,0.11215041842491046
1949,12,0,0.0,12,0,5233.0467567856385,14.166666666666666,0.13343910812291532
1950,14,3,0.21428571428571427,11,0,100451.05374022086,17.714285714285715,0.15254744206484677
1951,16,2,0.125,14,0,10745.881830520204,20.75,0.11048563381258882
1952,11,2,0.18181818181818182,9,0,608624.7262182963,59.45454545454545,0.12621164814003477
1953,48,9,0.1875,39,0,1526010.2148640242,31.125,0.13819950010189333
1954,16,5,0.3125,11,0,14503.337517673068,17.1875,0.11187266361640943
1955,45,4,0.08888888888888889,41,0,1136747.5765905976,38.577777777777776,0.14523704018616201
1956,96,12,0.125,84,0,437332.95551212365,21.145833333333332,0.12368522984681089
1957,22,3,0.13636363636363635,19,0,417164.2844021352,30.045454545454547,0.14391494043182715
1958,22,4,0.18181818181818182,18,0,528283.8564701207,39.45454545454545,0.11695843710951177
1959,24,5,0.20833333333333334,19,0,6779270.029231262,60.541666666666664,0.12040621128734263
1960,30,3,0.1,27,0,953.0422222222223,11.2,0.09725235684654186
1961,11,2,0.18181818181818182,9,0,197080.0469221184,12.272727272727273,0.12142183979704937
1962,14,3,0.21428571428571427,11,0,280.8715000658266,19.214285714285715,0.10681317850961673
1963,111,22,0.1981981981981982,89,0,446559.8383083357,23.71171171171171,0.11360500640028826
1964,11,3,0.2727272727272727,8,0,198990.3049924179,16.363636363636363,0.067301147349652
1965,25,9,0.36,16,0,1555566.8919313718,49.32,0.1429263652342985
1966,14,5,0.35714285714285715,9,0,916926.4183112475,30.5,0.15989516357172318
1967,61,12,0.19672131147540983,49,0,1473079.7871834899,38.868852459016395,0.1468456070155485
1968,41,7,0.17073170731707318,34,0,2465231.6551395888,76.8780487804878,0.1716559819254012
1969,12,5,0.4166666666666667,7,0,108124.15614510159,15.666666666666666,0.1334169104087137
1970,12,2,0.16666666666666666,10,0,183373.31187733216,11.666666666666666,0.09878893817687597
1971,11,1,0.09090909090909091,10,0,71303.41228024178,19.272727272727273,0.11444718972218361
1972,13,2,0.15384615384615385,11,0,25030.056508432594,19.692307692307693,0.1009484305424933
1973,12,1,0.08333333333333333,11,0,10320.56631311607,11.333333333333334,0.08169328996131098
1974,11,1,0.09090909090909091,10,0,51349.7728118788,18.363636363636363,0.14312846960524894
1975,11,4,0.36363636363636365,7,0,58358.65753420768,10.181818181818182,0.1209856938988639
1976,12,1,0.08333333333333333,11,0,8082.180241207753,13.0,0.12393714355808348
1977,13,1,0.07692307692307693,12,0,12141.215997290583,8.538461538461538,0.10011082288096881
1978,31,5,0.16129032258064516,26,0,671640.1432375519,30.161290322580644,0.1009160317727268
1979,116,34,0.29310344827586204,82,0,242374.91876695948,18.379310344827587,0.10966629840645253
1980,13,0,0.0,13,0,294481.91185773135,40.69230769230769,0.1407007831080733
1981,12,2,0.16666666666666666,10,0,60654.48191145612,11.25,0.10469687334946438
1982,17,2,0.11764705882352941,15,0,11564.471896172616,18.705882352941178,0.09315974048923883
1983,14,2,0.14285714285714285,12,0,35409.84850194419,14.214285714285714,0.1162583071547575
1984,33,6,0.18181818181818182,27,0,90403.37655098514,26.393939393939394,0.12525645303603197
1985,13,0,0.0,13,0,226050.27643092308,17.846153846153847,0.10133223240061508
1986,14,3,0.21428571428571427,11,0,47778.23103712626,80.57142857142857,0.11159291321966848
1987,18,6,0.3333333333333333,12,0,277530.8013422103,48.166666666666664,0.13513955672033937
1988,11,1,0.09090909090909091,10,0,149690.0819606525,11.818181818181818,0.08253217223925313
1989,12,2,0.16666666666666666,10,0,11416.697305265776,9.25,0.09767468637390346
1990,11,2,0.18181818181818182,9,0,1025649.4855762224,26.363636363636363,0.12010598578792318
1991,14,3,0.21428571428571427,11,0,15646.92450200234,14.642857142857142,0.1245192894370691
1992,12,1,0.08333333333333333,11,0,139233.77692512659,12.166666666666666,0.11162749969914902
1993,12,3,0.25,9,0,234449.2802613346,20.666666666666668,0.1277736688766514
1994,12,2,0.16666666666666666,10,0,1199930.1277608492,117.0,0.15029182075287612
1995,12,3,0.25,9,0,53496.69742626648,10.833333333333334,0.0926760254620229
1996,36,4,0.1111111111111111,32,0,157021.8563540692,32.52777777777778,0.12019595432037186
1997,12,4,0.3333333333333333,8,0,913096.2683914714,76.41666666666667,0.1531470817631838
1998,11,1,0.09090909090909091,10,0,24665.133963019587,11.363636363636363,0.10370623536504536
1999,12,2,0.16666666666666666,10,0,18284.578764289472,46.5,0.1126879028095294
2000,11,1,0.09090909090909091,10,0,19712.57071994462,10.545454545454545,0.11490609366200673
2001,11,2,0.18181818181818182,9,0,385274.0768338047,9.545454545454545,0.10121445566347624
2002,11,2,0.18181818181818182,9,0,34113.006971730756,54.27272727272727,0.12165198663495952
2003,11,0,0.0,11,0,197853.70523540315,14.727272727272727,0.13369890274509888
2004,15,3,0.2,12,0,45003.80525504855,20.333333333333332,0.09266166652087376
2005,12,3,0.25,9,0,12505.123006035488,38.0,0.10467331716001067
2006,12,1,0.08333333333333333,11,0,386248.13047063566,22.75,0.14090693983740354
2007,44,4,0.09090909090909091,40,0,291482.8263987489,36.22727272727273,0.10957578564074381
2008,12,2,0.16666666666666666,10,0,87549.87089351431,8.416666666666666,0.11747555968495116
2009,13,3,0.23076923076923078,10,0,45561.375526535456,10.846153846153847,0.12201007446750338
2010,11,2,0.18181818181818182,9,0,19753.872187685487,10.545454545454545,0.08286771084301495
2011,11,1,0.09090909090909091,10,0,322581.7196278535,37.27272727272727,0.1498397858829653
2012,18,1,0.05555555555555555,17,0,144872.02668265873,32.72222222222222,0.0920871420683722
2013,14,1,0.07142857142857142,13,0,80400.61528436387,36.357142857142854,0.10596882806710141
2014,14,4,0.2857142857142857,10,0,21008.838100827474,13.142857142857142,0.1395988924329368
2015,51,6,0.11764705882352941,45,0,172297.00747738546,28.725490196078432,0.11378435552883179
2016,11,0,0.0,11,0,8957.768313427536,10.0,0.08266571683696836
2017,16,3,0.1875,13,0,53246.63611896608,27.375,0.13041062366654524
2018,13,3,0.23076923076923078,10,0,90470.7405305349,60.38461538461539,0.13633739601307446
2019,11,1,0.09090909090909091,10,0,331666.83571458166,20.636363636363637,0.09512732889065893
2020,19,1,0.05263157894736842,18,0,175997.8557556053,17.68421052631579,0.1260485637562167
2021,64,10,0.15625,54,0,191389.82053887603,19.421875,0.10742267335647554
2022,49,6,0.12244897959183673,43,0,390393.8473698018,21.285714285714285,0.11432796903269833
2023,11,3,0.2727272727272727,8,0,309679.39209058287,14.818181818181818,0.148412829177581
2024,11,2,0.18181818181818182,9,0,358169.5843780733,15.727272727272727,0.13125844014851457
2025,12,0,0.0,12,0,117093.77954502404,27.583333333333332,0.10920274525985836
2026,11,3,0.2727272727272727,8,0,113043.76408187907,15.363636363636363,0.09752819505210447
2027,14,4,0.2857142857142857,10,0,26236.603595569468,9.928571428571429,0.08403562015581335
2028,16,4,0.25,12,0,132861.75018320663,35.125,0.10140167417219938
2029,11,1,0.09090909090909091,10,0,62362.87291916599,19.181818181818183,0.12412582331490629
2030,18,3,0.16666666666666666,15,0,68183.36596926788,28.166666666666668,0.09818684444211578
2031,11,0,0.0,11,0,115686.47402257157,21.454545454545453,0.1349693857033989
2032,90,17,0.18888888888888888,73,0,144533.5620630325,24.566666666666666,0.09390790135094067
2033,31,7,0.22580645161290322,24,0,53060.75034192347,19.35483870967742,0.09865698950370859
2034,11,2,0.18181818181818182,9,0,31147.529217518677,18.363636363636363,0.13809053394566465
2035,56,9,0.16071428571428573,47,0,161676.81013734016,20.678571428571427,0.11717839042570423
2036,63,5,0.07936507936507936,58,0,110645.86225026645,20.095238095238095,0.10878506324962174
2037,86,12,0.13953488372093023,74,0,155578.54230019666,24.674418604651162,0.10254043113049001
2038,15,3,0.2,12,0,102367.80410740481,42.733333333333334,0.12094022303334813
2039,12,0,0.0,12,0,49193.14425932036,12.25,0.12872443477399023
2040,12,1,0.08333333333333333,11,0,112939.3096820308,37.083333333333336,0.13900432099344462
2041,10,1,0.1,9,0,954590.6203614998,89.4,0.16126080710981291
2042,17,6,0.35294117647058826,11,0,23041.641758858645,14.529411764705882,0.13868668450332194
2043,16,1,0.0625,15,0,92175.15375078873,13.75,0.07967379316544401
2044,15,1,0.06666666666666667,14,0,389858.40187276696,15.2,0.09520527505196578
2045,14,3,0.21428571428571427,11,0,87138.68114873327,13.714285714285714,0.11891067025717969
2046,11,1,0.09090909090909091,10,0,19959.27365106106,47.90909090909091,0.09569515794362107
2047,11,3,0.2727272727272727,8,0,66407.6952231041,11.909090909090908,0.08066168631723143
2048,17,2,0.11764705882352941,15,0,170855.94646271577,15.941176470588236,0.11400788573691675
2049,12,2,0.16666666666666666,10,0,103210.73500381898,13.416666666666666,0.0832657506948513
2050,15,4,0.26666666666666666,11,0,480130.7912575676,12.0,0.12570567174075636
2051,13,0,0.0,13,0,24981.35398633058,45.07692307692308,0.10136267953836423
2052,11,1,0.09090909090909091,10,0,153482.57960773332,8.090909090909092,0.0813341673670963
2053,10,4,0.4,6,0,38718.7784060363,10.8,0.11557884550047001
2054,68,11,0.16176470588235295,57,0,179266.28517723453,16.264705882352942,0.1039728729988083
2055,13,3,0.23076923076923078,10,0,320488.3172417786,145.92307692307693,0.1457158915131159
2056,13,1,0.07692307692307693,12,0,80447.40958131255,13.615384615384615,0.13091332849236184
2057,13,2,0.15384615384615385,11,0,107297.61986073073,13.384615384615385,0.11303387005422602
2058,21,8,0.38095238095238093,13,0,62512.92515494829,20.238095238095237,0.08806108735422856
2059,16,3,0.1875,13,0,40611.5425183423,11.3125,0.1072876986961411
2060,22,5,0.22727272727272727,17,0,19871.397129627574,14.727272727272727,0.1055620332169669
2061,10,0,0.0,10,0,79490.77884614759,17.8,0.14768170587559365
2062,12,1,0.08333333333333333,11,0,45757.88888888888,10.333333333333334,0.08374956228790463
2063,63,18,0.2857142857142857,45,0,269542.0481565561,34.36507936507937,0.10659218067676078
2064,21,5,0.23809523809523808,16,0,159449.64260441886,44.23809523809524,0.12185291523747477
2065,171,25,0.14619883040935672,146,0,194020.20508305109,20.842105263157894,0.10494545123227281
2066,96,13,0.13541666666666666,83,0,116754.95128096669,38.0,0.11945877780136738
2067,12,1,0.08333333333333333,11,0,207201.76906300682,14.416666666666666,0.07994139682251242
2068,30,7,0.23333333333333334,23,0,66755.11636802758,16.633333333333333,0.10546523959248216
2069,117,18,0.15384615384615385,99,0,161467.8491633787,18.299145299145298,0.10911705105614669
2070,19,1,0.05263157894736842,18,0,54312.03775285931,8.631578947368421,0.09535693660890504
2071,32,3,0.09375,29,0,453481.0646436688,33.5625,0.11253997131245919
2072,22,3,0.13636363636363635,19,0,42186.039531374416,16.181818181818183,0.12258959969644852
2073,49,12,0.24489795918367346,37,0,294028.25827010506,33.0,0.1064243747288143
2074,10,2,0.2,8,0,49741.03880353586,21.6,0.13730003968237198
2075,25,2,0.08,23,0,321336.7295419878,19.0,0.13415429719423697
2076,116,17,0.14655172413793102,99,0,455102.7956494031,51.05172413793103,0.11832728058399604
2077,19,1,0.05263157894736842,18,0,411531.18218415516,21.263157894736842,0.1282356973418246
2078,17,3,0.17647058823529413,14,0,231235.78344282793,20.823529411764707,0.12928706334321666
2079,13,2,0.15384615384615385,11,0,339588.8611417216,69.15384615384616,0.1105016608007241
2080,29,5,0.1724137931034483,24,0,131514.2684114249,18.79310344827586,0.12272614252215532
2081,17,4,0.23529411764705882,13,0,62457.578259993534,21.294117647058822,0.1378118527968193
2082,38,5,0.13157894736842105,33,0,18926.84612862501,13.131578947368421,0.10134360256940718
2083,18,3,0.16666666666666666,15,0,33520.794232024666,15.333333333333334,0.09960037594948352
2084,15,3,0.2,12,0,144668.59070711487,20.4,0.10632929430926887
2085,14,2,0.14285714285714285,12,0,137467.74456884287,12.285714285714286,0.1112068312401677
2086,20,5,0.25,15,0,319985.18644669064,14.8,0.11392842569306054
2087,30,2,0.06666666666666667,28,0,35108.39437132783,11.133333333333333,0.10514004874946004
2088,16,3,0.1875,13,0,77434.35088870945,12.6875,0.11353368519676667
2089,21,6,0.2857142857142857,15,0,34686.70446921405,32.523809523809526,0.09607364076903127
2090,29,1,0.034482758620689655,28,0,226407.37044229044,51.310344827586206,0.11670075361915076
2091,25,5,0.2,20,0,134772.96993838216,42.48,0.10452042768138503
2092,60,7,0.11666666666666667,53,0,387632.04521986766,21.266666666666666,0.10249369747370612
2093,21,6,0.2857142857142857,15,0,17257.940034277643,14.666666666666666,0.11782077008950158
2094,10,5,0.5,5,0,3224.535590975866,11.2,0.09001712516294619
2095,16,4,0.25,12,0,524300.8763792358,16.25,0.08228861989778236
2096,1969,341,0.17318435754189945,1628,0,157221.563730375,23.004062976130015,0.10915213558805198
