,total,LMICs,LMICs_perc,HICs,Unknown,Avg BC,Avg DC,Avg CC
0,3203,268,0.0836715579144552,2935,0,103695.38825861063,13.867624102403996,0.06054912303523754
1,17,1,0.058823529411764705,16,0,377401.8768520152,12.176470588235293,0.053715859946677644
2,14,1,0.07142857142857142,13,0,116361.2999518361,12.714285714285714,0.06783615972462845
3,12,0,0.0,12,0,48408.96741958914,15.666666666666666,0.07486579654387943
4,32,5,0.15625,27,0,12239.175566320662,14.875,0.06482438442574628
5,27,7,0.25925925925925924,20,0,5930.9221880082205,14.851851851851851,0.06584062501322291
6,30,2,0.06666666666666667,28,0,241438.9677566463,19.6,0.06909043044423956
7,16,2,0.125,14,0,21424.333553517106,12.5625,0.054223142879796196
8,27,2,0.07407407407407407,25,0,24507.214604040862,24.11111111111111,0.07156593168820508
9,24,1,0.041666666666666664,23,0,188682.28435441165,10.166666666666666,0.04443612543087646
10,26,3,0.11538461538461539,23,0,235904.87427241297,15.846153846153847,0.0732033907133532
11,30,5,0.16666666666666666,25,0,8890.824606395614,11.533333333333333,0.06466922257159155
12,34,1,0.029411764705882353,33,0,25024.367446560096,7.764705882352941,0.040300751359701785
13,35,6,0.17142857142857143,29,0,4765.426119234071,11.771428571428572,0.06044438259065513
14,27,1,0.037037037037037035,26,0,245843.92802911208,18.22222222222222,0.07890054751391345
15,17,1,0.058823529411764705,16,0,0.031703590527119935,13.529411764705882,0.08037400847740445
16,23,0,0.0,23,0,143651.54224441916,10.130434782608695,0.059420498641357074
17,15,4,0.26666666666666666,11,0,0.05925925925925927,12.333333333333334,0.06307456101629953
18,14,3,0.21428571428571427,11,0,3965.4205908594604,12.071428571428571,0.06388978471580234
19,33,4,0.12121212121212122,29,0,192993.5206202143,14.151515151515152,0.060045903958435724
20,18,2,0.1111111111111111,16,0,62476.316349371366,12.666666666666666,0.046660530236998655
21,11,0,0.0,11,0,8749.040164933926,18.818181818181817,0.06677719873396976
22,30,2,0.06666666666666667,28,0,43326.19340637574,11.8,0.04815432817978852
23,34,3,0.08823529411764706,31,0,48424.83143999129,8.705882352941176,0.0446389351575588
24,21,2,0.09523809523809523,19,0,7993.80284382167,4.857142857142857,0.0339235073646132
25,13,3,0.23076923076923078,10,0,31.489198447531827,12.538461538461538,0.05430664363969736
26,22,3,0.13636363636363635,19,0,269963.11672525195,18.681818181818183,0.05935300934017462
27,22,1,0.045454545454545456,21,0,37458.83523032581,13.181818181818182,0.06626198510311014
28,31,0,0.0,31,0,410431.58086668036,15.129032258064516,0.06285274749345744
29,20,5,0.25,15,0,379678.17164540483,25.2,0.08465047549751771
30,57,8,0.14035087719298245,49,0,648177.7712415035,15.929824561403509,0.07174113557554261
31,36,2,0.05555555555555555,34,0,192850.29292474294,17.444444444444443,0.07042570188319425
32,21,2,0.09523809523809523,19,0,95963.53221241783,14.333333333333334,0.05380975208520377
33,27,1,0.037037037037037035,26,0,312250.38147829624,15.296296296296296,0.05853300274118639
34,12,2,0.16666666666666666,10,0,94646.51744394832,21.333333333333332,0.081995312175094
35,34,3,0.08823529411764706,31,0,79096.40050579449,15.588235294117647,0.07222751335884853
36,22,2,0.09090909090909091,20,0,719662.5300399459,21.181818181818183,0.06806888788289925
37,34,3,0.08823529411764706,31,0,112754.52177611443,13.0,0.06464962515918703
38,19,1,0.05263157894736842,18,0,5839.3694330867265,19.68421052631579,0.06705084120430517
39,13,1,0.07692307692307693,12,0,241.25912458160266,9.384615384615385,0.03811542439355304
40,16,1,0.0625,15,0,0.0,9.125,0.0374766002662055
41,32,1,0.03125,31,0,260720.84178045735,11.28125,0.0641372160182242
42,20,5,0.25,15,0,9823.629945756062,14.6,0.04854901105473408
43,20,2,0.1,18,0,262378.3842337298,15.6,0.04888557656513917
44,17,0,0.0,17,0,166337.14281745092,16.58823529411765,0.0651221455156566
45,16,1,0.0625,15,0,17483.75805245802,14.6875,0.06557007310257734
46,23,2,0.08695652173913043,21,0,97937.55877228685,18.608695652173914,0.06179241521665531
47,19,2,0.10526315789473684,17,0,2467.6842105263167,10.421052631578947,0.06360916496851099
48,24,2,0.08333333333333333,22,0,138103.2859600193,16.458333333333332,0.04780142596174349
49,19,1,0.05263157894736842,18,0,97488.72786484686,16.57894736842105,0.06315841458906107
50,24,5,0.20833333333333334,19,0,40955.26712185608,13.791666666666666,0.06460212957829659
51,22,1,0.045454545454545456,21,0,91171.27617084264,10.136363636363637,0.04475554001955137
52,16,2,0.125,14,0,57745.912632172454,10.75,0.057587424900770685
53,28,3,0.10714285714285714,25,0,129519.07046604175,17.214285714285715,0.06893245362307845
54,15,0,0.0,15,0,4650.031416953667,9.933333333333334,0.0573348947787907
55,27,2,0.07407407407407407,25,0,65153.22125998392,10.37037037037037,0.05649388404347383
56,15,0,0.0,15,0,0.0,7.066666666666666,0.04860047604354956
57,17,0,0.0,17,0,381871.1819064445,25.941176470588236,0.07504853730107534
58,22,3,0.13636363636363635,19,0,12459.509802454244,17.227272727272727,0.04529718731735415
59,30,0,0.0,30,0,89334.23875998848,16.833333333333332,0.06917688834808265
60,25,1,0.04,24,0,653308.2607179788,14.64,0.07511911958227271
61,36,4,0.1111111111111111,32,0,2799.6286494107844,8.527777777777779,0.04547219732986433
62,13,0,0.0,13,0,6591.8184992157685,10.692307692307692,0.03287951474346525
63,27,6,0.2222222222222222,21,0,161154.80967959278,16.296296296296298,0.06714938851133484
64,79,3,0.0379746835443038,76,0,96576.6509475255,12.759493670886076,0.06147188227681739
65,12,0,0.0,12,0,19524.062176552605,12.916666666666666,0.054144632278410244
66,28,2,0.07142857142857142,26,0,22872.537762443855,11.928571428571429,0.060359267923590594
67,26,3,0.11538461538461539,23,0,198695.7272231838,9.807692307692308,0.06253462910673965
68,16,1,0.0625,15,0,149935.6263467287,14.375,0.058630721156268474
69,22,3,0.13636363636363635,19,0,15677.861598176474,14.590909090909092,0.06126504810433211
70,29,5,0.1724137931034483,24,0,8285.591080248456,9.758620689655173,0.047660706221585046
71,22,2,0.09090909090909091,20,0,37998.42795661634,12.909090909090908,0.06259485056747972
72,29,3,0.10344827586206896,26,0,12931.172413793103,12.793103448275861,0.06655751197228857
73,32,3,0.09375,29,0,85574.97336434576,16.71875,0.06258100482455645
74,15,1,0.06666666666666667,14,0,3194.9922640820864,11.733333333333333,0.07645950524950772
75,16,1,0.0625,15,0,57738.721594650946,16.125,0.06673690927576875
76,19,1,0.05263157894736842,18,0,7927.345029237557,17.210526315789473,0.0822451861281496
77,20,3,0.15,17,0,88443.42935752263,15.5,0.054291708630301916
78,27,4,0.14814814814814814,23,0,14918.950997250435,15.333333333333334,0.05752385284691221
79,19,2,0.10526315789473684,17,0,4908.368717024497,11.578947368421053,0.06384858942847194
80,30,3,0.1,27,0,229991.9153897962,17.433333333333334,0.06011955097551454
81,34,2,0.058823529411764705,32,0,579353.4564144253,17.147058823529413,0.06582959154122045
82,33,5,0.15151515151515152,28,0,162617.32205550102,16.575757575757574,0.061167472706091436
83,11,1,0.09090909090909091,10,0,28830.985861247722,28.09090909090909,0.05773684427394277
84,27,2,0.07407407407407407,25,0,75027.26212520237,8.185185185185185,0.04372402356503186
85,14,2,0.14285714285714285,12,0,0.9673262828465413,9.714285714285714,0.056816192708952544
86,24,3,0.125,21,0,15119.79362496241,8.125,0.04778660869653304
87,27,2,0.07407407407407407,25,0,7631.41036265135,11.703703703703704,0.0650714161291982
88,20,1,0.05,19,0,76321.03999868636,25.2,0.07837622532413328
89,18,1,0.05555555555555555,17,0,56294.992718420755,14.666666666666666,0.06559582602030231
90,14,2,0.14285714285714285,12,0,4.764285714285714,8.714285714285714,0.0628655396523306
91,34,0,0.0,34,0,234202.77079257846,13.529411764705882,0.050940755040581
92,16,3,0.1875,13,0,44159.682205911755,11.25,0.053169938847966454
93,15,1,0.06666666666666667,14,0,586.5468854830376,14.0,0.07832534213462314
94,20,2,0.1,18,0,0.0,11.75,0.061229616927870344
95,23,4,0.17391304347826086,19,0,97064.28566049277,17.652173913043477,0.061657092110296005
96,16,1,0.0625,15,0,45470.49620918999,13.0625,0.06297071008094965
97,26,1,0.038461538461538464,25,0,193033.924199462,12.846153846153847,0.05936195968911683
98,17,1,0.058823529411764705,16,0,0.0,12.058823529411764,0.04757108010549845
99,17,1,0.058823529411764705,16,0,68858.63822622296,23.823529411764707,0.06884532739406261
100,38,2,0.05263157894736842,36,0,72602.17510067746,14.552631578947368,0.062345531622757945
101,13,3,0.23076923076923078,10,0,9233.414485281213,11.846153846153847,0.07228291215464687
102,17,1,0.058823529411764705,16,0,343546.7964639798,15.588235294117647,0.05511001120656121
103,19,1,0.05263157894736842,18,0,10.526315789473685,11.473684210526315,0.05202724763029068
104,12,0,0.0,12,0,1.1904761904761905,14.5,0.046165699411130946
105,28,2,0.07142857142857142,26,0,56124.47032538198,13.285714285714286,0.06620121189082946
106,23,3,0.13043478260869565,20,0,5247.610072137116,12.91304347826087,0.055908125915124486
107,32,3,0.09375,29,0,158885.97098774428,5.8125,0.03502867836891009
108,25,2,0.08,23,0,100642.16004051319,14.84,0.056816071967395916
109,11,0,0.0,11,0,0.0,10.545454545454545,0.07251699306155784
110,18,2,0.1111111111111111,16,0,2.888888888888889,14.38888888888889,0.05735433586360081
111,10,0,0.0,10,0,1354539.1319474776,14.5,0.07678329457633723
112,17,3,0.17647058823529413,14,0,18308.588695597366,14.823529411764707,0.06907024419296504
113,24,2,0.08333333333333333,22,0,64359.6473125821,18.5,0.05985217874905296
114,18,2,0.1111111111111111,16,0,26417.879742249777,13.11111111111111,0.048050278398568784
115,13,2,0.15384615384615385,11,0,18611.344922373228,9.307692307692308,0.04632251996762156
116,13,0,0.0,13,0,6940.069297935882,11.0,0.06049025980365842
117,20,1,0.05,19,0,7340.204099160968,25.3,0.047204884050812086
118,22,2,0.09090909090909091,20,0,39678.78428493214,7.545454545454546,0.034919118570255696
119,17,1,0.058823529411764705,16,0,20226.810954631717,12.588235294117647,0.041543119323482786
120,18,2,0.1111111111111111,16,0,104312.64952718726,15.0,0.06746288455195457
121,23,3,0.13043478260869565,20,0,23357.37878340632,14.26086956521739,0.0632631340121125
122,16,4,0.25,12,0,202474.23076629572,14.4375,0.05647902090851467
123,17,1,0.058823529411764705,16,0,93187.45836305508,16.176470588235293,0.06256701205241962
124,18,1,0.05555555555555555,17,0,98803.77873752675,16.27777777777778,0.06371287842012587
125,30,3,0.1,27,0,4299.108815396606,11.633333333333333,0.05297393391462342
126,19,2,0.10526315789473684,17,0,60180.040051184034,9.68421052631579,0.04281734107782685
127,21,1,0.047619047619047616,20,0,11754.648739028135,16.047619047619047,0.07984479273918169
128,11,3,0.2727272727272727,8,0,27247.786240864407,16.363636363636363,0.06231516241659325
129,34,3,0.08823529411764706,31,0,4188.380319319932,12.323529411764707,0.061653784243801794
130,17,0,0.0,17,0,109444.6283138448,26.764705882352942,0.09292664434973773
131,21,1,0.047619047619047616,20,0,67646.24275049832,22.761904761904763,0.07902165852402826
132,15,0,0.0,15,0,15906.928366082258,22.8,0.09341330775994049
133,27,4,0.14814814814814814,23,0,48597.401433862404,5.555555555555555,0.04843037464203132
134,33,4,0.12121212121212122,29,0,2.296372819100092,11.606060606060606,0.04231571734654267
135,16,0,0.0,16,0,168467.23788697904,18.25,0.06690414382641884
136,21,2,0.09523809523809523,19,0,24765.26297164233,18.333333333333332,0.06696699104393615
137,23,1,0.043478260869565216,22,0,112695.10953594792,20.73913043478261,0.06884382005693607
138,36,2,0.05555555555555555,34,0,94413.68812550684,12.11111111111111,0.05615111800451665
139,24,1,0.041666666666666664,23,0,1270.936350434523,16.75,0.07313350181111086
140,23,0,0.0,23,0,53387.4239466486,15.521739130434783,0.0671124294477602
141,23,5,0.21739130434782608,18,0,24684.91680591143,13.043478260869565,0.05673117765772897
142,23,2,0.08695652173913043,21,0,419263.3253067303,15.91304347826087,0.05017439206278316
143,20,1,0.05,19,0,219450.77269185762,13.65,0.07252778916212065
144,16,1,0.0625,15,0,81498.2377660138,15.1875,0.07429878682069536
145,21,2,0.09523809523809523,19,0,171491.93054007392,13.666666666666666,0.06784494942394141
146,22,0,0.0,22,0,86465.72555819777,12.181818181818182,0.06401268135827297
147,19,2,0.10526315789473684,17,0,2238.3852583003422,13.894736842105264,0.05677163634566441
148,18,0,0.0,18,0,119728.67828147988,22.11111111111111,0.07141478044451327
149,13,1,0.07692307692307693,12,0,19215.74282950774,15.076923076923077,0.0769674961750907
150,24,2,0.08333333333333333,22,0,103223.2573275899,11.708333333333334,0.054449449124035175
151,14,0,0.0,14,0,158249.10558892973,12.785714285714286,0.06508130554666788
152,23,1,0.043478260869565216,22,0,38412.09637538928,22.0,0.06663610548101766
153,17,5,0.29411764705882354,12,0,1073.0615667326956,13.823529411764707,0.05741252390839682
154,37,3,0.08108108108108109,34,0,280463.56556528196,13.243243243243244,0.062289238272407954
155,16,2,0.125,14,0,5860.5,11.5625,0.06165208175387705
156,25,0,0.0,25,0,24585.908158298167,15.24,0.060970772200313564
157,15,0,0.0,15,0,254135.50986655752,14.8,0.06733592030584652
158,15,0,0.0,15,0,0.06666666666666667,10.733333333333333,0.06813658744492444
159,39,4,0.10256410256410256,35,0,193202.65487179527,11.76923076923077,0.05187603367671645
160,31,6,0.1935483870967742,25,0,87142.93741308669,11.67741935483871,0.06579174340669973
161,27,0,0.0,27,0,17140.431388818604,8.62962962962963,0.06171094356422518
162,50,6,0.12,44,0,6927.895178050644,10.66,0.061360198364497985
163,13,2,0.15384615384615385,11,0,0.0,11.461538461538462,0.06874953497139391
164,21,4,0.19047619047619047,17,0,23406.306456467017,12.80952380952381,0.056368113444979176
165,19,1,0.05263157894736842,18,0,311318.14028108475,20.31578947368421,0.0743660594745893
166,20,1,0.05,19,0,3520.309716782781,11.5,0.05240874174000917
167,13,0,0.0,13,0,107105.62329464864,18.153846153846153,0.06567803965099456
168,25,1,0.04,24,0,259376.55478240387,9.64,0.04779381802062125
169,11,2,0.18181818181818182,9,0,0.0,13.272727272727273,0.037253651136322424
170,13,2,0.15384615384615385,11,0,4282.182692307692,15.076923076923077,0.05480241513970045
171,27,0,0.0,27,0,53865.039756148595,14.555555555555555,0.058487106951870725
172,24,1,0.041666666666666664,23,0,71509.86322084058,13.0,0.04536621598514171
173,23,0,0.0,23,0,64238.081869796646,12.347826086956522,0.05137427537152572
174,17,2,0.11764705882352941,15,0,1571.4369148055885,14.058823529411764,0.065544552125533
175,11,0,0.0,11,0,6816.019138754643,10.909090909090908,0.06306260161195999
176,23,1,0.043478260869565216,22,0,180601.4311886286,12.608695652173912,0.07338794596004326
177,28,7,0.25,21,0,13464.739380596488,10.535714285714286,0.04454890631511334
178,12,1,0.08333333333333333,11,0,11877.433035020047,19.083333333333332,0.07643581993115582
179,19,0,0.0,19,0,18211.6436526481,15.842105263157896,0.059656032007697105
180,17,2,0.11764705882352941,15,0,176108.1637011672,11.705882352941176,0.04778843332558258
181,33,5,0.15151515151515152,28,0,104091.92732469809,13.818181818181818,0.06115114413778955
182,19,2,0.10526315789473684,17,0,0.0,10.631578947368421,0.05339340987034911
183,12,0,0.0,12,0,181473.49351506264,12.0,0.04233959799641721
184,16,2,0.125,14,0,0.0,8.0,0.029471813594872522
185,27,4,0.14814814814814814,23,0,468757.5929561307,19.22222222222222,0.06704335240186445
186,12,3,0.25,9,0,29250.0,14.0,0.076762656160637
187,19,2,0.10526315789473684,17,0,118222.19833602535,19.05263157894737,0.08405432354148196
188,22,2,0.09090909090909091,20,0,109517.92745835436,13.136363636363637,0.06655794538688574
189,36,7,0.19444444444444445,29,0,70241.436501072,13.527777777777779,0.06083421941499234
190,32,2,0.0625,30,0,54248.10735411566,13.46875,0.057151433874366095
191,30,2,0.06666666666666667,28,0,60291.781901043076,8.3,0.052429327432342215
192,14,0,0.0,14,0,216885.3749729461,13.142857142857142,0.07348721185589656
193,20,4,0.2,16,0,486.9057900806012,12.2,0.06692201250132017
194,20,1,0.05,19,0,8045.442688492278,12.15,0.04088567386450469
195,13,1,0.07692307692307693,12,0,6165.729908686782,11.538461538461538,0.08453789861682738
196,15,1,0.06666666666666667,14,0,141978.2276023457,22.733333333333334,0.08533568896668296
197,28,1,0.03571428571428571,27,0,39116.70037243584,7.821428571428571,0.04727225572811151
198,12,2,0.16666666666666666,10,0,0.0,12.583333333333334,0.07765073999547696
199,21,2,0.09523809523809523,19,0,326620.8658158447,21.476190476190474,0.07922409589028365
200,46,2,0.043478260869565216,44,0,6186.775961268732,11.91304347826087,0.06182794116373949
201,30,5,0.16666666666666666,25,0,927.3201832985379,10.3,0.05682597881421549
202,34,3,0.08823529411764706,31,0,119507.27918983273,16.794117647058822,0.06412580241550354
203,32,2,0.0625,30,0,24096.44225077376,12.90625,0.060123340130636097
204,30,2,0.06666666666666667,28,0,123633.45537319218,7.0,0.03863945146141677
205,34,1,0.029411764705882353,33,0,98210.24854608344,14.588235294117647,0.053496950403895044
206,15,1,0.06666666666666667,14,0,7357.646195288554,13.666666666666666,0.0762212817285655
207,25,1,0.04,24,0,4500.63510755772,12.76,0.052729162754226414
208,45,3,0.06666666666666667,42,0,387701.58203316986,12.977777777777778,0.04338036961426927
209,16,1,0.0625,15,0,27652.582897318352,10.0,0.0611515521080441
210,25,3,0.12,22,0,160862.05684166157,12.6,0.059997329686666365
211,34,7,0.20588235294117646,27,0,158593.54962414037,17.5,0.06971702221620707
212,21,1,0.047619047619047616,20,0,759261.127171057,30.666666666666668,0.08438147201484456
213,18,1,0.05555555555555555,17,0,232363.412799283,12.555555555555555,0.06491987454640769
214,16,2,0.125,14,0,62486.262052911465,13.5625,0.07033836002575998
215,30,0,0.0,30,0,250269.69614833503,23.733333333333334,0.0735785677434378
216,13,1,0.07692307692307693,12,0,0.0,12.692307692307692,0.05624276414481095
217,94,5,0.05319148936170213,89,0,145714.62930932446,12.457446808510639,0.055914047390641944
218,19,1,0.05263157894736842,18,0,81011.4369749188,20.157894736842106,0.07110505299921221
219,18,2,0.1111111111111111,16,0,7566.605390544374,10.5,0.06082547029205562
220,22,3,0.13636363636363635,19,0,5554.118240040444,12.363636363636363,0.06287083259688249
221,33,3,0.09090909090909091,30,0,260151.43371287378,10.484848484848484,0.05172320407907157
222,22,5,0.22727272727272727,17,0,150456.0213389461,17.772727272727273,0.06119065567494544
223,22,1,0.045454545454545456,21,0,20635.711771897062,10.045454545454545,0.05432918097278749
224,11,1,0.09090909090909091,10,0,0.0,12.090909090909092,0.05276778679223582
225,12,0,0.0,12,0,7814.0,7.583333333333333,0.03992474279324023
226,17,4,0.23529411764705882,13,0,354.1528086704818,13.058823529411764,0.06850860211781057
227,20,1,0.05,19,0,71254.31867843385,15.05,0.0547036684701401
228,13,1,0.07692307692307693,12,0,2874.4156361597143,14.076923076923077,0.06278513566962905
229,26,4,0.15384615384615385,22,0,0.0,12.73076923076923,0.056170908932389144
230,14,3,0.21428571428571427,11,0,41.714285714285715,12.0,0.04823887745346257
231,22,2,0.09090909090909091,20,0,154214.86346230173,14.590909090909092,0.05198093222264472
232,22,2,0.09090909090909091,20,0,41153.529001754774,14.954545454545455,0.08553932129479039
233,21,1,0.047619047619047616,20,0,115967.95313953533,19.571428571428573,0.08703705341801325
234,13,0,0.0,13,0,13539.81252461075,18.692307692307693,0.08431391083357657
235,11,0,0.0,11,0,2131.090909090909,18.636363636363637,0.0619522166337047
236,19,3,0.15789473684210525,16,0,81676.05926304747,14.31578947368421,0.04837797949158601
237,19,2,0.10526315789473684,17,0,5754.792799497379,11.68421052631579,0.06599964067874715
238,22,2,0.09090909090909091,20,0,3668.0050505030795,11.363636363636363,0.05217183142217327
239,13,0,0.0,13,0,287655.5814770638,11.384615384615385,0.06669552636282619
240,137,10,0.072992700729927,127,0,293745.6466140395,14.27007299270073,0.06039382620348337
241,20,2,0.1,18,0,84464.29219875995,15.9,0.08367781010978212
242,15,5,0.3333333333333333,10,0,41313.28158061028,17.866666666666667,0.06874587347305196
243,22,3,0.13636363636363635,19,0,406283.61986276467,11.863636363636363,0.060959287167227275
244,14,0,0.0,14,0,7813.457181062434,8.928571428571429,0.06119236143683059
245,10,0,0.0,10,0,0.2,6.6,0.03716977119925885
246,24,3,0.125,21,0,69453.4524883674,16.333333333333332,0.04547641129536023
247,23,1,0.043478260869565216,22,0,1045980.9875414621,32.69565217391305,0.06783689090842816
248,20,3,0.15,17,0,12588.434896941439,13.4,0.07025245681754609
249,24,3,0.125,21,0,189829.59220782152,18.916666666666668,0.06875181517499222
250,11,2,0.18181818181818182,9,0,10183.832679625646,15.181818181818182,0.056465391547865965
251,30,7,0.23333333333333334,23,0,28138.464991141358,12.5,0.05881834080525869
252,25,2,0.08,23,0,37981.81612924541,10.68,0.05550266479783886
253,12,2,0.16666666666666666,10,0,296454.65980828553,15.083333333333334,0.06405123122689078
254,24,4,0.16666666666666666,20,0,21697.328392205363,13.375,0.06003751852960895
255,15,4,0.26666666666666666,11,0,14199.331504181491,11.933333333333334,0.06458718048056009
256,35,4,0.11428571428571428,31,0,5268.008423244557,14.685714285714285,0.06619218186982971
257,28,2,0.07142857142857142,26,0,353279.7939312795,17.714285714285715,0.053842431062201254
258,23,1,0.043478260869565216,22,0,339258.6459723659,20.782608695652176,0.06969240541154366
259,14,0,0.0,14,0,94815.93941956102,11.857142857142858,0.05461779365588531
260,21,2,0.09523809523809523,19,0,458178.9829941375,20.428571428571427,0.06460118214126587
261,20,0,0.0,20,0,13.5,10.25,0.05017770352399274
262,32,1,0.03125,31,0,139538.53774099608,12.21875,0.063785132549256
263,15,1,0.06666666666666667,14,0,68277.12527345841,17.0,0.05919722762362512
264,13,1,0.07692307692307693,12,0,104764.3668647775,18.615384615384617,0.08174829957063842
265,16,1,0.0625,15,0,91384.26177895945,25.375,0.07778748354188489
266,46,3,0.06521739130434782,43,0,79532.4779747975,10.021739130434783,0.055508872749927385
267,29,0,0.0,29,0,76822.28243685796,15.379310344827585,0.05703142866467033
268,14,1,0.07142857142857142,13,0,93130.47478208368,16.214285714285715,0.0598711018565421
269,26,2,0.07692307692307693,24,0,176564.82829642514,12.846153846153847,0.05511460560966364
270,25,2,0.08,23,0,71103.53516254449,24.88,0.06725464942533273
271,40,5,0.125,35,0,100195.45461616253,8.95,0.048115516888486934
272,33,3,0.09090909090909091,30,0,1544.2880659710322,15.121212121212121,0.06067783118355488
273,12,1,0.08333333333333333,11,0,99137.04639827959,12.333333333333334,0.06617366267221739
274,14,1,0.07142857142857142,13,0,118022.03599006568,16.714285714285715,0.06408165719352335
275,22,2,0.09090909090909091,20,0,4304.573714335005,9.863636363636363,0.06774460437701331
276,34,4,0.11764705882352941,30,0,43469.72237999287,16.852941176470587,0.0701470549829672
277,17,0,0.0,17,0,6107.458257297004,13.117647058823529,0.06671740329165446
278,111,13,0.11711711711711711,98,0,172914.57607917138,11.54054054054054,0.05678658009316577
279,14,2,0.14285714285714285,12,0,11091.73983963722,15.285714285714286,0.05497681445141594
280,29,2,0.06896551724137931,27,0,10288.191455982334,10.413793103448276,0.05927470680610648
281,28,1,0.03571428571428571,27,0,11015.99233597085,11.035714285714286,0.046409407262578146
282,11,1,0.09090909090909091,10,0,21309.636363636364,16.0,0.09021952184890437
283,30,1,0.03333333333333333,29,0,43769.56209064787,13.6,0.06633259268506216
284,33,3,0.09090909090909091,30,0,61025.614202622026,16.393939393939394,0.055050852603416474
285,25,1,0.04,24,0,7825.0814545116655,5.6,0.036185459671239435
286,23,3,0.13043478260869565,20,0,586.1761784790112,13.956521739130435,0.05768278625830212
287,29,2,0.06896551724137931,27,0,35745.35093792699,13.379310344827585,0.06660629524919183
288,18,1,0.05555555555555555,17,0,262169.6047557637,18.333333333333332,0.06299711468381657
289,15,1,0.06666666666666667,14,0,0.0,14.4,0.06634124627456317
290,12,1,0.08333333333333333,11,0,30193.21550614521,17.416666666666668,0.05634658630795108
291,32,2,0.0625,30,0,8103.129968290234,10.46875,0.05188658821393053
292,20,1,0.05,19,0,70946.08886472069,14.25,0.07370289131998867
293,21,3,0.14285714285714285,18,0,541595.5853147706,16.285714285714285,0.06805644181350491
294,18,2,0.1111111111111111,16,0,14774.533222411617,18.72222222222222,0.06955999538321081
295,25,3,0.12,22,0,3421.995611975284,13.2,0.0682328833264422
296,15,2,0.13333333333333333,13,0,27869.202144420567,16.0,0.06848084617271998
297,14,5,0.35714285714285715,9,0,133.64449824319516,14.214285714285714,0.058585686289574126
298,15,1,0.06666666666666667,14,0,73937.19392125812,16.4,0.0691288401853755
299,21,4,0.19047619047619047,17,0,12181.44530478097,10.476190476190476,0.04099890405344619
300,17,1,0.058823529411764705,16,0,80363.15769102692,9.235294117647058,0.033760599782355544
301,19,2,0.10526315789473684,17,0,145643.22994758945,15.894736842105264,0.05566121615285858
302,11,1,0.09090909090909091,10,0,64295.37504573888,12.727272727272727,0.04848179170790625
303,22,2,0.09090909090909091,20,0,125565.01016879627,16.545454545454547,0.0732983440042225
304,16,2,0.125,14,0,13100.095662847809,12.875,0.05018168851057952
305,16,2,0.125,14,0,13265.514902418507,15.75,0.06962269816194717
306,17,4,0.23529411764705882,13,0,5515.764705882354,13.647058823529411,0.06590805158739335
307,14,1,0.07142857142857142,13,0,57364.509119257666,7.357142857142857,0.05279672484183726
308,12,2,0.16666666666666666,10,0,31250.666666666668,20.916666666666668,0.07507702762759275
309,32,3,0.09375,29,0,74738.01370781077,13.375,0.05526004021481177
310,20,2,0.1,18,0,0.0,12.95,0.062206767518750095
311,48,3,0.0625,45,0,113436.72426023723,17.4375,0.06820256435079519
312,20,1,0.05,19,0,78408.17327273233,14.75,0.05380881094496972
313,16,0,0.0,16,0,25834.05382354239,12.625,0.0521531334889201
314,35,3,0.08571428571428572,32,0,89779.92982231335,11.085714285714285,0.048685862785388175
315,11,0,0.0,11,0,369465.2727272727,10.909090909090908,0.05664246907701076
316,16,3,0.1875,13,0,6669.395497974407,8.1875,0.031054658478185233
317,15,1,0.06666666666666667,14,0,37655.25988544248,16.466666666666665,0.08061721807765629
318,14,4,0.2857142857142857,10,0,0.0,10.0,0.06088800195017942
319,17,1,0.058823529411764705,16,0,32460.414468580933,5.176470588235294,0.03793940188901927
320,12,2,0.16666666666666666,10,0,10043.705221673768,10.25,0.043916284054890564
321,23,2,0.08695652173913043,21,0,6296.711493095284,12.478260869565217,0.0555050152250554
322,24,3,0.125,21,0,154378.11969925786,18.458333333333332,0.07685728873887689
323,21,3,0.14285714285714285,18,0,126516.8402771386,17.285714285714285,0.06890232804614337
324,30,4,0.13333333333333333,26,0,13541.851344222045,9.6,0.04149094484710931
325,12,0,0.0,12,0,15311.749998948711,10.75,0.032406489429267306
326,19,0,0.0,19,0,11150.53199582608,12.631578947368421,0.061914785548627074
327,28,4,0.14285714285714285,24,0,1.1111111111111116,9.321428571428571,0.03153800613350654
328,14,4,0.2857142857142857,10,0,77346.90977569806,10.571428571428571,0.05540668728693281
329,30,2,0.06666666666666667,28,0,32183.35288057993,10.633333333333333,0.057476165700293784
330,11,2,0.18181818181818182,9,0,0.0,23.818181818181817,0.06585774675602797
331,17,4,0.23529411764705882,13,0,35105.95185444521,18.470588235294116,0.06436314671295715
332,12,0,0.0,12,0,47530.57709010594,16.916666666666668,0.07297789627626913
333,24,3,0.125,21,0,85448.99830191955,9.75,0.047959461627246076
334,29,8,0.27586206896551724,21,0,61516.68000782511,15.758620689655173,0.05801677782382876
335,21,5,0.23809523809523808,16,0,486650.47453973937,21.38095238095238,0.07430999148942614
336,18,4,0.2222222222222222,14,0,21465.24081474066,14.5,0.05245804997524685
337,16,1,0.0625,15,0,66574.94375553509,13.0625,0.05866729121498179
338,16,1,0.0625,15,0,33074.677137598694,6.8125,0.05015811553882969
339,12,0,0.0,12,0,8211.043018584352,18.416666666666668,0.060214543417994794
340,33,5,0.15151515151515152,28,0,7478.08617254928,10.575757575757576,0.05203840485558276
341,18,1,0.05555555555555555,17,0,381123.90404282376,19.11111111111111,0.06438519008727707
342,12,1,0.08333333333333333,11,0,19935.806077456986,10.916666666666666,0.042889041201051505
343,19,0,0.0,19,0,937.2874850651242,11.052631578947368,0.056037477836062916
344,30,4,0.13333333333333333,26,0,223185.6041277718,18.8,0.07603541605830878
345,20,2,0.1,18,0,106079.8862879184,10.45,0.054004897840511254
346,33,1,0.030303030303030304,32,0,86531.82681870658,16.303030303030305,0.05322903656664784
347,24,1,0.041666666666666664,23,0,39105.39559538791,14.291666666666666,0.06917168041983553
348,16,0,0.0,16,0,136.13468954946006,4.3125,0.010427981883570834
349,13,0,0.0,13,0,26176.822564941485,14.076923076923077,0.05905070998590852
350,21,2,0.09523809523809523,19,0,29123.838812053298,14.904761904761905,0.05716767061196159
351,19,2,0.10526315789473684,17,0,0.0,14.894736842105264,0.06010936694360815
352,17,3,0.17647058823529413,14,0,0.0,7.0588235294117645,0.03338038194417653
353,25,0,0.0,25,0,107004.15363029596,8.28,0.04796561698658789
354,11,0,0.0,11,0,0.0,12.272727272727273,0.05860753418955076
355,15,2,0.13333333333333333,13,0,0.0,10.2,0.0710144351798335
356,22,0,0.0,22,0,2170.6873287618296,13.454545454545455,0.06233819021630185
357,30,3,0.1,27,0,127163.23370817768,15.266666666666667,0.06245864279149006
358,16,3,0.1875,13,0,717.8946061144981,9.5,0.04980841522151818
359,19,2,0.10526315789473684,17,0,62452.43270469448,16.36842105263158,0.07089884739714773
360,31,1,0.03225806451612903,30,0,98359.95024178704,9.225806451612904,0.04654157217185733
361,16,2,0.125,14,0,73621.61807684004,13.5,0.0667466057118217
362,19,2,0.10526315789473684,17,0,1548229.4259069155,16.526315789473685,0.05733559007165612
363,17,1,0.058823529411764705,16,0,11030.58823529412,21.11764705882353,0.0930971839675965
364,56,5,0.08928571428571429,51,0,55926.22133863795,10.160714285714286,0.056805415322995545
365,14,0,0.0,14,0,10035.064769683062,13.071428571428571,0.07131293976696448
366,17,2,0.11764705882352941,15,0,2613.0157584703275,15.058823529411764,0.05383959430681709
367,19,1,0.05263157894736842,18,0,240952.49055475928,15.68421052631579,0.06367487991796243
368,19,4,0.21052631578947367,15,0,0.0,8.526315789473685,0.0317579202704247
369,15,0,0.0,15,0,1562.8000000000002,13.333333333333334,0.057046976369037126
370,17,3,0.17647058823529413,14,0,19987.003230030215,14.823529411764707,0.04390504011698173
371,26,4,0.15384615384615385,22,0,163994.1185463173,15.0,0.06941231078202702
372,29,2,0.06896551724137931,27,0,0.0,12.482758620689655,0.052460516750724114
373,15,2,0.13333333333333333,13,0,44879.211984272035,16.466666666666665,0.06159553805653525
374,13,3,0.23076923076923078,10,0,121794.95011886918,18.23076923076923,0.06328272234483888
375,26,4,0.15384615384615385,22,0,133674.24773542324,14.0,0.07022806998442176
376,24,2,0.08333333333333333,22,0,13672.583333333334,11.333333333333334,0.05567415228603359
377,22,1,0.045454545454545456,21,0,154450.73492427042,10.863636363636363,0.06275131617679522
378,30,4,0.13333333333333333,26,0,299492.77388357464,20.066666666666666,0.07177006671096736
379,17,1,0.058823529411764705,16,0,509.15004485840666,14.764705882352942,0.05714302810272369
380,29,1,0.034482758620689655,28,0,39550.63100924481,15.655172413793103,0.07112133721103697
381,13,0,0.0,13,0,3606.6153846153848,15.23076923076923,0.0505701325765222
382,17,2,0.11764705882352941,15,0,276052.02868122404,22.470588235294116,0.06949618736536542
383,13,1,0.07692307692307693,12,0,10824.636442949422,15.76923076923077,0.07001810775841627
384,19,4,0.21052631578947367,15,0,15605.083531886437,15.210526315789474,0.062384606299861096
385,19,4,0.21052631578947367,15,0,100786.68833187623,14.31578947368421,0.06040091110447482
386,12,2,0.16666666666666666,10,0,0.0,13.333333333333334,0.07106139559860458
387,25,2,0.08,23,0,70807.42796820294,23.56,0.07448102203240081
388,34,4,0.11764705882352941,30,0,20689.540306863128,7.970588235294118,0.04612482911910905
389,36,5,0.1388888888888889,31,0,177067.46353268952,14.916666666666666,0.05180868764189851
390,19,1,0.05263157894736842,18,0,15008.164391715723,6.894736842105263,0.027229009883569962
391,16,1,0.0625,15,0,0.0,11.4375,0.0514576736735501
392,22,2,0.09090909090909091,20,0,11202.59243771713,9.545454545454545,0.043785879377745064
393,21,0,0.0,21,0,172045.31030667742,15.380952380952381,0.055566901949757004
394,24,1,0.041666666666666664,23,0,117064.61448547641,10.875,0.060787302121727955
395,18,0,0.0,18,0,1916742.0251750355,16.333333333333332,0.04926308083203823
396,12,2,0.16666666666666666,10,0,664261.5914323215,31.0,0.08150694419666714
397,12,0,0.0,12,0,15969.181371783117,15.75,0.08435850585413858
398,17,3,0.17647058823529413,14,0,0.0,10.823529411764707,0.06711846410340855
399,16,2,0.125,14,0,291816.12535851187,15.625,0.06015920107517114
400,13,0,0.0,13,0,5.896231669783782,11.692307692307692,0.05152703476812874
401,16,2,0.125,14,0,11450.417324158934,10.125,0.06463988638834961
402,11,1,0.09090909090909091,10,0,0.0,10.909090909090908,0.04185467701128957
403,21,1,0.047619047619047616,20,0,0.0,12.428571428571429,0.04221981515419009
404,18,4,0.2222222222222222,14,0,68683.65005426573,12.88888888888889,0.06935900842587794
405,52,7,0.1346153846153846,45,0,148772.94011027223,10.653846153846153,0.04414082304198008
406,39,3,0.07692307692307693,36,0,132872.52789105725,12.794871794871796,0.051261225432146874
407,12,1,0.08333333333333333,11,0,24096.638191591268,12.083333333333334,0.058186692199240116
408,14,2,0.14285714285714285,12,0,48.470147189770564,10.0,0.06385361808893572
409,19,2,0.10526315789473684,17,0,11723.82755166018,10.789473684210526,0.048443751473215446
410,17,3,0.17647058823529413,14,0,45445.834559687406,14.176470588235293,0.044134962871641155
411,26,4,0.15384615384615385,22,0,4460.123068661177,7.038461538461538,0.042083963823525146
412,17,2,0.11764705882352941,15,0,662265.8607241594,17.11764705882353,0.06616511680394384
413,16,3,0.1875,13,0,68668.4182943257,10.4375,0.05487876425647133
414,14,2,0.14285714285714285,12,0,10607.864359931447,14.642857142857142,0.06569956147507586
415,20,3,0.15,17,0,3.8325505853594586,9.45,0.052225315023003
416,27,3,0.1111111111111111,24,0,0.0,9.148148148148149,0.04279332168247865
417,23,3,0.13043478260869565,20,0,129116.18763414517,21.695652173913043,0.07201923859934187
418,13,1,0.07692307692307693,12,0,77786.70204717248,12.615384615384615,0.061421333089825565
419,24,3,0.125,21,0,98575.57122554514,8.833333333333334,0.04469019895017896
420,12,3,0.25,9,0,398085.49362727086,16.75,0.08202151798333127
421,13,0,0.0,13,0,1784.8321848411017,11.384615384615385,0.05088026779143508
422,22,1,0.045454545454545456,21,0,61194.59900316827,15.227272727272727,0.05673281656811109
423,20,3,0.15,17,0,127044.01884717125,15.95,0.07032899508345611
424,15,1,0.06666666666666667,14,0,15625.999999999998,14.933333333333334,0.061465903741085993
425,20,1,0.05,19,0,57804.63345371854,15.95,0.05737993531435333
426,21,2,0.09523809523809523,19,0,783.4015086226722,12.380952380952381,0.05143314454713725
427,20,4,0.2,16,0,2344.2999999999997,19.0,0.06899781899540992
428,16,1,0.0625,15,0,44910.4125749436,16.25,0.06920976539251975
429,37,3,0.08108108108108109,34,0,45016.34946518446,8.702702702702704,0.05700588461624843
430,23,2,0.08695652173913043,21,0,59767.085413751665,24.217391304347824,0.08012720699146199
431,18,2,0.1111111111111111,16,0,333238.4459598091,24.22222222222222,0.08213172979409936
432,20,4,0.2,16,0,31512.470587689564,14.45,0.05624386697707887
433,35,3,0.08571428571428572,32,0,441630.8614202711,18.142857142857142,0.06704324656293387
434,20,1,0.05,19,0,34036.88062458072,23.6,0.07416093056478232
435,13,0,0.0,13,0,13562.110155905973,14.307692307692308,0.06289988054778703
436,25,0,0.0,25,0,146165.56202392967,12.44,0.06752816528798236
437,30,1,0.03333333333333333,29,0,213157.8327716754,13.833333333333334,0.06028350352063786
438,25,1,0.04,24,0,41040.14361634373,15.28,0.048609960666200935
439,17,2,0.11764705882352941,15,0,0.0,7.294117647058823,0.04046274115413977
440,20,3,0.15,17,0,80926.91183343352,14.65,0.06492118540337391
441,16,0,0.0,16,0,9500.231819192222,14.0,0.06425824124918612
442,11,1,0.09090909090909091,10,0,100261.72727275662,29.727272727272727,0.09303610048577679
443,24,2,0.08333333333333333,22,0,102148.35042626678,11.916666666666666,0.06416687188158042
444,24,4,0.16666666666666666,20,0,23129.85335504983,22.416666666666668,0.07031503435185825
445,21,3,0.14285714285714285,18,0,61821.12993044831,29.761904761904763,0.08258975347845247
446,19,2,0.10526315789473684,17,0,169969.10557165425,11.68421052631579,0.052595012113627736
447,26,3,0.11538461538461539,23,0,150576.33231136098,12.384615384615385,0.06212590906620231
448,16,0,0.0,16,0,168000.46545703267,22.0625,0.06320863083423796
449,22,2,0.09090909090909091,20,0,391262.2716949634,11.363636363636363,0.045462779178506656
450,25,0,0.0,25,0,168512.34498894628,13.28,0.05572007355810881
451,19,4,0.21052631578947367,15,0,3838.3629148199557,8.631578947368421,0.04984167934054687
452,25,4,0.16,21,0,5857.626190997012,23.4,0.0696923358492784
453,18,4,0.2222222222222222,14,0,59615.12207395906,20.555555555555557,0.06413659904271135
454,34,2,0.058823529411764705,32,0,24997.722427336816,13.117647058823529,0.05173515000256118
455,24,4,0.16666666666666666,20,0,222379.46415589636,12.5,0.06532950196043802
456,18,2,0.1111111111111111,16,0,11700.46960572483,11.666666666666666,0.04961873707717315
457,14,2,0.14285714285714285,12,0,32489.826956701978,9.0,0.05008198550258851
458,19,1,0.05263157894736842,18,0,66.00877192982455,12.263157894736842,0.04328693451103451
459,21,1,0.047619047619047616,20,0,224631.23640894305,20.0,0.062478706168555706
460,11,1,0.09090909090909091,10,0,0.0,13.454545454545455,0.0691584653520478
461,11,1,0.09090909090909091,10,0,16500.825296823987,28.272727272727273,0.0799544779701583
462,12,0,0.0,12,0,0.0,13.333333333333334,0.04754902296477664
463,21,0,0.0,21,0,635.9049032949783,14.238095238095237,0.05643553896962064
464,35,2,0.05714285714285714,33,0,65437.31197442235,11.571428571428571,0.05369132554948793
465,18,3,0.16666666666666666,15,0,69071.62192712155,25.88888888888889,0.0710513747970618
466,18,0,0.0,18,0,0.0,9.444444444444445,0.058220823104802255
467,17,3,0.17647058823529413,14,0,0.5392156862745099,13.176470588235293,0.0617391115278657
468,20,3,0.15,17,0,191800.97887860038,16.65,0.07318717746491593
469,20,1,0.05,19,0,168062.1333753785,14.05,0.06744967832217756
470,15,1,0.06666666666666667,14,0,100236.0109565677,12.466666666666667,0.0633882889373352
471,12,1,0.08333333333333333,11,0,0.0,12.833333333333334,0.050703563340062464
472,15,3,0.2,12,0,7826.450525281093,12.666666666666666,0.05801728940182009
473,13,0,0.0,13,0,111.66217473613952,16.153846153846153,0.08214085440618633
474,28,1,0.03571428571428571,27,0,51513.35680106831,11.25,0.062086123792555944
475,18,3,0.16666666666666666,15,0,90073.3242239613,10.88888888888889,0.048271856799403705
476,28,2,0.07142857142857142,26,0,35316.60855901077,12.428571428571429,0.07270680357307177
477,23,1,0.043478260869565216,22,0,108424.58693296224,12.782608695652174,0.062121807317877094
478,40,2,0.05,38,0,11078.99481326665,15.3,0.0593798088151138
479,18,3,0.16666666666666666,15,0,26448.656434484063,14.61111111111111,0.07581154721401678
480,19,2,0.10526315789473684,17,0,40807.827865592844,13.894736842105264,0.07108620971330512
481,22,1,0.045454545454545456,21,0,320943.95098295226,18.227272727272727,0.06692535263667936
482,16,2,0.125,14,0,64410.5,11.125,0.057123739554362576
483,20,3,0.15,17,0,2346.5,10.55,0.05679024243352354
484,19,1,0.05263157894736842,18,0,10250.830753179085,14.736842105263158,0.06493158631039285
485,13,2,0.15384615384615385,11,0,123321.4420009427,19.53846153846154,0.07341136759377874
486,12,1,0.08333333333333333,11,0,81390.61758080192,15.916666666666666,0.05900458936691069
487,16,1,0.0625,15,0,0.0,8.5,0.03956652500815949
488,27,0,0.0,27,0,240527.23399342393,14.88888888888889,0.045617818281096796
489,12,1,0.08333333333333333,11,0,148593.66349268888,20.25,0.06755000479174439
490,22,1,0.045454545454545456,21,0,26864.780310572336,15.954545454545455,0.04622548417082853
491,20,3,0.15,17,0,208318.03382278007,16.85,0.05268052460960265
492,14,2,0.14285714285714285,12,0,0.0,9.142857142857142,0.0370863322277971
493,39,4,0.10256410256410256,35,0,152744.2742853666,9.923076923076923,0.04867282935224438
494,16,1,0.0625,15,0,31285.43200990745,18.1875,0.06105511763375604
495,16,3,0.1875,13,0,64977.530374427595,16.875,0.05454690520380927
496,12,3,0.25,9,0,3907.1666666666674,14.083333333333334,0.08170352261398665
497,24,2,0.08333333333333333,22,0,188129.30751108206,23.666666666666668,0.07794036167499586
498,13,1,0.07692307692307693,12,0,20298.24871235261,11.0,0.0653834806356797
499,13,2,0.15384615384615385,11,0,0.15384615384615385,11.461538461538462,0.04736831097895225
500,25,1,0.04,24,0,22361.16804412729,16.72,0.06715515861649352
501,18,2,0.1111111111111111,16,0,10137.795858901793,12.222222222222221,0.06446432392342945
502,18,0,0.0,18,0,20833.314351851852,12.61111111111111,0.06836722766587883
503,14,1,0.07142857142857142,13,0,14791.040836177843,13.642857142857142,0.052471867243285
504,20,2,0.1,18,0,42041.65794560428,16.25,0.07628738164004481
505,11,0,0.0,11,0,3764.9113927168405,21.818181818181817,0.05870326606520405
506,21,2,0.09523809523809523,19,0,8102.069310994887,16.714285714285715,0.05451889408885905
507,22,3,0.13636363636363635,19,0,21225.43572738653,12.909090909090908,0.06264301563062415
508,17,1,0.058823529411764705,16,0,78695.43794939383,14.529411764705882,0.07325973310051023
509,18,1,0.05555555555555555,17,0,5400.238691450563,10.166666666666666,0.06240215791424326
510,16,3,0.1875,13,0,10801.260854416414,13.5,0.08083982087207131
511,18,3,0.16666666666666666,15,0,49000.84239508661,13.333333333333334,0.06146131821046774
512,15,1,0.06666666666666667,14,0,847574.5094478094,17.333333333333332,0.06938340623914208
513,15,1,0.06666666666666667,14,0,1976.7396337971625,10.933333333333334,0.049693257929907385
514,13,3,0.23076923076923078,10,0,0.4307692307692308,12.692307692307692,0.04630695999731581
515,12,2,0.16666666666666666,10,0,11721.5,13.166666666666666,0.07787097985447212
516,12,0,0.0,12,0,74827.29062532083,14.25,0.04575499828605232
517,23,2,0.08695652173913043,21,0,106058.68611489664,15.608695652173912,0.0596271791437566
518,26,2,0.07692307692307693,24,0,47607.43555332366,15.576923076923077,0.04899320545921261
519,27,0,0.0,27,0,78964.83946032556,11.11111111111111,0.06253810129132899
520,33,2,0.06060606060606061,31,0,188968.87969650805,7.606060606060606,0.038247996152662916
521,40,1,0.025,39,0,15483.18298294498,8.25,0.047788976473851566
522,21,2,0.09523809523809523,19,0,357742.4695193888,18.047619047619047,0.06056803240920766
523,13,1,0.07692307692307693,12,0,106382.6721408385,13.0,0.04780178623906918
524,12,2,0.16666666666666666,10,0,15627.166666666666,9.416666666666666,0.05905689147342241
525,18,0,0.0,18,0,38097.494016252254,10.277777777777779,0.043977523518776235
526,18,2,0.1111111111111111,16,0,32705.974486511044,14.666666666666666,0.07306698307815507
527,20,2,0.1,18,0,151959.5191061147,8.45,0.05739899348491706
528,21,0,0.0,21,0,298231.38137924264,15.857142857142858,0.07443051331500075
529,32,1,0.03125,31,0,2344.6530623505832,8.90625,0.04666096004979256
530,19,3,0.15789473684210525,16,0,102437.04978009294,22.31578947368421,0.07531136575733087
531,21,1,0.047619047619047616,20,0,367684.37084609596,28.238095238095237,0.07810487689318969
532,17,3,0.17647058823529413,14,0,10255.987023146707,12.352941176470589,0.04853105906717331
533,27,5,0.18518518518518517,22,0,75873.59466975012,11.555555555555555,0.05221435134132283
534,13,2,0.15384615384615385,11,0,5315.760081570769,16.615384615384617,0.07709686708194328
535,31,3,0.0967741935483871,28,0,32660.504724429054,11.96774193548387,0.05795810093921271
536,20,2,0.1,18,0,1.7499999999999996,12.0,0.05669225434590791
537,21,3,0.14285714285714285,18,0,43775.471240619525,13.333333333333334,0.06646845259324172
538,16,2,0.125,14,0,88049.87810064018,15.5625,0.052028609026028905
539,35,2,0.05714285714285714,33,0,2689.492817474674,16.228571428571428,0.05293875511684933
540,13,0,0.0,13,0,9797.434141944306,18.153846153846153,0.0701365488885374
541,25,2,0.08,23,0,100921.32275007936,13.48,0.0617451306716201
542,28,1,0.03571428571428571,27,0,235098.61689305035,18.607142857142858,0.072324964279276
543,14,0,0.0,14,0,2509.771610835357,16.714285714285715,0.06212690159131658
544,12,2,0.16666666666666666,10,0,5122.192863088796,19.166666666666668,0.07130984849126783
545,20,2,0.1,18,0,1233.9795182850753,15.65,0.06732915299230613
546,33,2,0.06060606060606061,31,0,46330.98741486002,10.909090909090908,0.06275128751793221
547,32,4,0.125,28,0,249063.416545223,16.1875,0.05173975562344112
548,18,3,0.16666666666666666,15,0,15743.983347346428,16.5,0.08757864626731601
549,22,2,0.09090909090909091,20,0,123678.62351875482,12.772727272727273,0.04740420078955418
550,15,1,0.06666666666666667,14,0,8343.721754592729,14.533333333333333,0.06385481421159628
551,27,3,0.1111111111111111,24,0,89220.97803321945,14.925925925925926,0.06641847064989535
552,14,2,0.14285714285714285,12,0,32328.99218016215,14.285714285714286,0.07763973729847837
553,30,2,0.06666666666666667,28,0,20217.154408440227,12.566666666666666,0.06028581338709335
554,20,3,0.15,17,0,31571.09352639207,13.5,0.046776454630356415
555,11,0,0.0,11,0,21803.061569397545,13.272727272727273,0.05384118930902733
556,18,2,0.1111111111111111,16,0,43940.6512317392,2.5,0.01650199527677861
557,28,1,0.03571428571428571,27,0,17494.99189735963,8.107142857142858,0.04985173885579547
558,29,3,0.10344827586206896,26,0,30916.629102898532,6.758620689655173,0.042422932760308736
559,16,1,0.0625,15,0,160089.11586873676,25.0625,0.07545633611433943
560,29,3,0.10344827586206896,26,0,85037.88052873484,11.379310344827585,0.045362539681667785
561,15,0,0.0,15,0,17066.21981974561,12.533333333333333,0.05625392535155997
562,12,1,0.08333333333333333,11,0,0.0,11.25,0.04374923973103956
563,12,1,0.08333333333333333,11,0,1.1428571428571426,8.833333333333334,0.06032758717687151
564,33,2,0.06060606060606061,31,0,48675.07192261924,11.848484848484848,0.06277810358269185
565,20,1,0.05,19,0,36474.183616251845,11.8,0.048716793687420636
566,12,1,0.08333333333333333,11,0,68881.7746510486,17.75,0.06910163086751743
567,17,2,0.11764705882352941,15,0,13784.146837682441,16.11764705882353,0.07065831856662268
568,19,2,0.10526315789473684,17,0,62945.151124661286,15.052631578947368,0.061726281739718496
569,11,2,0.18181818181818182,9,0,72410.74641148325,19.181818181818183,0.06640783949107515
570,22,2,0.09090909090909091,20,0,59200.5968882536,15.227272727272727,0.07122648717754478
571,18,1,0.05555555555555555,17,0,166516.45512754252,13.11111111111111,0.06598454888365686
572,11,0,0.0,11,0,77272.9970367215,21.545454545454547,0.0724261578416823
573,50,8,0.16,42,0,34680.57797750067,14.32,0.06365239282058484
574,25,3,0.12,22,0,20734.314478800552,15.04,0.07068289046116125
575,20,0,0.0,20,0,4688.4,10.3,0.04602792238432556
576,19,2,0.10526315789473684,17,0,167198.32859972594,13.0,0.06060150218783085
577,12,0,0.0,12,0,216.14581003226135,8.083333333333334,0.05406537737780769
578,30,3,0.1,27,0,276448.8631580657,12.633333333333333,0.05311187779570359
579,21,3,0.14285714285714285,18,0,43405.01392524346,15.333333333333334,0.05950942507465543
580,17,1,0.058823529411764705,16,0,14839.758201669132,15.941176470588236,0.08021085112529756
581,15,1,0.06666666666666667,14,0,46226.9479139476,13.0,0.05723428468166314
582,13,4,0.3076923076923077,9,0,3418.6777278427244,16.46153846153846,0.055181581899249696
583,31,4,0.12903225806451613,27,0,90028.07136157808,12.67741935483871,0.06093925187750755
584,12,1,0.08333333333333333,11,0,314863.5540083675,15.5,0.0744321990408746
585,29,2,0.06896551724137931,27,0,315733.8022413547,12.96551724137931,0.060143750206719616
586,41,4,0.0975609756097561,37,0,16966.1696025976,17.634146341463413,0.06799545359231055
587,30,5,0.16666666666666666,25,0,131004.19189579456,13.566666666666666,0.05730402450227976
588,20,3,0.15,17,0,166750.8395681105,23.7,0.08500940100838873
589,25,3,0.12,22,0,4218.5462149696095,2.24,0.018535799108307275
590,13,1,0.07692307692307693,12,0,0.0,10.076923076923077,0.028348116355112894
591,23,4,0.17391304347826086,19,0,4112.488042899119,12.608695652173912,0.05661498889175648
592,21,1,0.047619047619047616,20,0,653666.4512574936,12.904761904761905,0.0535728292672966
593,27,3,0.1111111111111111,24,0,193850.77778831328,15.814814814814815,0.05614944231474587
594,18,1,0.05555555555555555,17,0,822287.501158991,16.055555555555557,0.06098716169521908
595,33,3,0.09090909090909091,30,0,9552.090099491186,12.06060606060606,0.06630496268351879
596,20,1,0.05,19,0,140798.2234738053,6.15,0.042751812750257474
597,13,1,0.07692307692307693,12,0,1.0417359969116597,16.23076923076923,0.06817842684332205
598,32,5,0.15625,27,0,22740.210144275392,15.8125,0.04982636637023255
599,36,3,0.08333333333333333,33,0,15258.009557603735,5.972222222222222,0.03764434420906869
600,24,1,0.041666666666666664,23,0,491236.72698901145,18.333333333333332,0.05384325458841468
601,28,2,0.07142857142857142,26,0,86894.38633995697,16.25,0.06029588391717966
602,19,0,0.0,19,0,8221.789473688248,9.052631578947368,0.04414946828776326
603,31,5,0.16129032258064516,26,0,12947.34482151567,11.709677419354838,0.05830496410354692
604,17,1,0.058823529411764705,16,0,5515.803921568628,10.294117647058824,0.04585830206581942
605,12,2,0.16666666666666666,10,0,228730.2791617205,11.0,0.05491910580302035
606,19,3,0.15789473684210525,16,0,4935.1578947368425,9.842105263157896,0.047167557891662173
607,13,1,0.07692307692307693,12,0,3417.020607230428,15.384615384615385,0.05470221533159143
608,21,1,0.047619047619047616,20,0,319879.0722665529,18.80952380952381,0.07873038157233662
609,19,0,0.0,19,0,366912.28863695404,22.0,0.06277484230351627
610,14,2,0.14285714285714285,12,0,30816.940318949266,14.285714285714286,0.05762470123374792
611,21,2,0.09523809523809523,19,0,54531.1033739774,14.428571428571429,0.05011671149017476
612,33,3,0.09090909090909091,30,0,36907.69696969697,10.212121212121213,0.049481972783562506
613,23,5,0.21739130434782608,18,0,50728.33089725762,12.434782608695652,0.05667119737163122
614,26,3,0.11538461538461539,23,0,366365.13241820264,23.423076923076923,0.06720986583256353
615,22,1,0.045454545454545456,21,0,116887.83514353569,11.272727272727273,0.05254646706619952
616,17,0,0.0,17,0,8059.233903208943,7.411764705882353,0.04802467014114834
617,30,4,0.13333333333333333,26,0,54954.664266229345,13.733333333333333,0.06825612661955228
618,30,4,0.13333333333333333,26,0,57446.06781874013,12.866666666666667,0.06498863974205678
619,31,2,0.06451612903225806,29,0,207920.4965887199,19.29032258064516,0.05846769332257542
620,22,3,0.13636363636363635,19,0,14917.363636363636,11.772727272727273,0.06667579093564116
621,18,2,0.1111111111111111,16,0,72062.31678609947,21.555555555555557,0.06746745700603814
622,13,3,0.23076923076923078,10,0,10820.0,9.538461538461538,0.05011287076961188
623,12,1,0.08333333333333333,11,0,567.5571705885452,15.583333333333334,0.05743099720999514
624,15,2,0.13333333333333333,13,0,0.0,14.066666666666666,0.07037637176874662
625,32,4,0.125,28,0,84511.22013496674,9.15625,0.04462129613358365
626,20,2,0.1,18,0,188246.82819060524,17.95,0.041474517754841095
627,21,4,0.19047619047619047,17,0,93801.8026687797,16.857142857142858,0.07318970951936782
628,19,1,0.05263157894736842,18,0,33082.32940448934,12.473684210526315,0.07268883673010283
629,14,0,0.0,14,0,939.2557018866756,16.642857142857142,0.07533953126960716
630,20,1,0.05,19,0,113611.25141836202,15.7,0.07480147213165292
631,14,1,0.07142857142857142,13,0,19981.77862636806,15.357142857142858,0.06653163152517202
632,13,0,0.0,13,0,0.6153846153846154,11.384615384615385,0.047916515662529406
633,23,4,0.17391304347826086,19,0,36681.084593311236,6.739130434782608,0.03289328417429201
634,16,2,0.125,14,0,7145.72328629753,14.875,0.04858908661670098
635,19,2,0.10526315789473684,17,0,31510.718099464906,9.894736842105264,0.04725453353520719
636,14,2,0.14285714285714285,12,0,22460.37400283153,8.214285714285714,0.03204733217343936
637,20,3,0.15,17,0,4688.4,10.6,0.042710911406481505
638,19,3,0.15789473684210525,16,0,442707.26823332964,12.052631578947368,0.0596322517438042
639,16,2,0.125,14,0,157398.57481382778,9.6875,0.058209175463648316
640,17,2,0.11764705882352941,15,0,995.8466716129277,17.0,0.06796538381340157
641,23,3,0.13043478260869565,20,0,10098.258833064829,13.304347826086957,0.0692742593973825
642,19,1,0.05263157894736842,18,0,488151.97187701083,11.947368421052632,0.06348438195337561
643,19,1,0.05263157894736842,18,0,37329.83307598929,14.210526315789474,0.04165053017957986
644,17,1,0.058823529411764705,16,0,122027.39600436407,24.176470588235293,0.05807472775410196
645,13,0,0.0,13,0,3673.4708640584813,13.846153846153847,0.07691413649434972
646,14,1,0.07142857142857142,13,0,0.0,9.5,0.04674691724588407
647,19,2,0.10526315789473684,17,0,2337.970240034854,14.421052631578947,0.06667677929121407
648,23,2,0.08695652173913043,21,0,115806.73227238428,18.956521739130434,0.07233191764194691
649,16,1,0.0625,15,0,4975.341459328955,15.75,0.08547553865690569
650,14,3,0.21428571428571427,11,0,0.07142857142857142,9.214285714285714,0.03932596503282164
651,19,2,0.10526315789473684,17,0,259849.3768446219,17.63157894736842,0.05046866759491431
652,23,1,0.043478260869565216,22,0,9196.814126445619,13.695652173913043,0.0764991308719709
653,31,1,0.03225806451612903,30,0,58007.16292630631,11.935483870967742,0.049982457889308746
654,17,0,0.0,17,0,149268.10240638343,15.176470588235293,0.050187942617665945
655,15,0,0.0,15,0,400879.52817542694,21.4,0.07513587327464924
656,17,2,0.11764705882352941,15,0,1558.848679511471,9.705882352941176,0.048211586086767164
657,17,1,0.058823529411764705,16,0,87396.57589368761,17.764705882352942,0.07598368773740877
658,12,0,0.0,12,0,25494.9001642764,22.75,0.08243710369992617
659,29,3,0.10344827586206896,26,0,8926.159678357784,10.724137931034482,0.05431643728941108
660,17,3,0.17647058823529413,14,0,13885.401649130685,12.058823529411764,0.05892191275652617
661,21,0,0.0,21,0,482581.1774177986,21.38095238095238,0.05766019024869956
662,34,7,0.20588235294117646,27,0,33805.24180828042,12.264705882352942,0.06616990225419675
663,14,0,0.0,14,0,19218.1272779206,15.5,0.048104298282843384
664,16,3,0.1875,13,0,411804.0730857363,13.9375,0.052803815638102006
665,19,1,0.05263157894736842,18,0,11164.809249801672,3.0526315789473686,0.0302365953222894
666,11,1,0.09090909090909091,10,0,14201.303030310006,14.727272727272727,0.05411915965362612
667,18,2,0.1111111111111111,16,0,13647.402148975225,13.88888888888889,0.048676523491483555
668,15,0,0.0,15,0,325827.80009764235,12.0,0.05067726006827897
669,12,1,0.08333333333333333,11,0,139589.22351081594,12.666666666666666,0.07212837288826222
670,16,0,0.0,16,0,1279468.6082071306,28.9375,0.0905878958178514
671,21,4,0.19047619047619047,17,0,7153.33259091146,15.523809523809524,0.06319114333628126
672,14,2,0.14285714285714285,12,0,4209.476424404051,10.428571428571429,0.05353584921223352
673,16,3,0.1875,13,0,77259.89072878065,14.3125,0.06749836760154984
674,11,0,0.0,11,0,563179.48051809,32.72727272727273,0.0817539147456054
675,22,3,0.13636363636363635,19,0,206723.0055322052,15.636363636363637,0.05453013583441225
676,17,1,0.058823529411764705,16,0,27586.9876555309,15.470588235294118,0.07182835121406625
677,14,2,0.14285714285714285,12,0,239050.6848046984,14.0,0.06582256847940511
678,13,2,0.15384615384615385,11,0,6555.077784798532,13.0,0.05738855152785734
679,30,5,0.16666666666666666,25,0,1827.0141067025024,9.8,0.05310407108512832
680,17,1,0.058823529411764705,16,0,153424.90488441786,16.294117647058822,0.05853487880086566
681,22,0,0.0,22,0,25488.65666923616,14.863636363636363,0.06653639583690621
682,20,0,0.0,20,0,66934.67197595842,12.45,0.058226282263601645
683,20,3,0.15,17,0,88120.4906817795,15.0,0.07159372143760277
684,30,2,0.06666666666666667,28,0,159581.6677496668,9.666666666666666,0.052656936567778104
685,24,3,0.125,21,0,154860.00092522718,6.25,0.03439820921383436
686,20,1,0.05,19,0,262405.26743179385,13.55,0.06801512695101891
687,14,1,0.07142857142857142,13,0,1006.031547834692,10.0,0.05459950933544909
688,47,6,0.1276595744680851,41,0,122608.55189355431,10.808510638297872,0.0597049677785153
689,24,4,0.16666666666666666,20,0,121012.37926838698,14.833333333333334,0.07054721137825282
690,21,2,0.09523809523809523,19,0,24905.034048415153,11.952380952380953,0.06487939541620455
691,32,4,0.125,28,0,19426.637741694034,13.4375,0.058778596954385434
692,28,2,0.07142857142857142,26,0,8181.739123964742,10.821428571428571,0.05976363847178707
693,18,2,0.1111111111111111,16,0,34247.04446220492,11.277777777777779,0.06753814800655827
694,18,0,0.0,18,0,96273.020688222,10.944444444444445,0.0745404191000373
695,28,1,0.03571428571428571,27,0,38953.274637536946,14.642857142857142,0.06747553480257511
696,14,1,0.07142857142857142,13,0,13550.123767629368,8.857142857142858,0.047860707271755766
697,64,2,0.03125,62,0,107892.72188981096,13.734375,0.05465057971239102
698,19,1,0.05263157894736842,18,0,122755.48864076265,16.842105263157894,0.07161559260347033
699,12,0,0.0,12,0,0.16666666666666666,10.833333333333334,0.052999176195531274
700,13,0,0.0,13,0,19881.35044246542,17.153846153846153,0.04662764989658877
701,11,4,0.36363636363636365,7,0,0.0,11.0,0.07124998059597716
702,14,1,0.07142857142857142,13,0,197308.96360582145,21.928571428571427,0.08224934668132322
703,24,3,0.125,21,0,72089.51077356726,13.416666666666666,0.05985779083718782
704,23,0,0.0,23,0,58228.966572273726,13.826086956521738,0.05736158449406095
705,27,1,0.037037037037037035,26,0,19100.166666666668,14.444444444444445,0.06765885105575056
706,28,4,0.14285714285714285,24,0,42520.89706567795,8.785714285714286,0.05008832976003176
707,28,4,0.14285714285714285,24,0,0.01020408163265306,10.464285714285714,0.04643467748450293
708,17,0,0.0,17,0,65384.56101317609,20.11764705882353,0.07561105211212273
709,31,3,0.0967741935483871,28,0,105172.70045408302,9.064516129032258,0.05125570703616298
710,15,2,0.13333333333333333,13,0,0.0,13.733333333333333,0.07911002930913782
711,11,1,0.09090909090909091,10,0,0.0,11.363636363636363,0.06589906310569361
712,15,1,0.06666666666666667,14,0,132235.35115983343,15.4,0.061250540039673736
713,29,2,0.06896551724137931,27,0,106270.58172414255,13.482758620689655,0.057465708566057545
714,17,2,0.11764705882352941,15,0,178274.4875848747,6.764705882352941,0.02895293914604186
715,16,3,0.1875,13,0,136.94406004735768,10.125,0.06387422310122108
716,14,1,0.07142857142857142,13,0,627.5982142857141,7.857142857142857,0.031232502365751067
717,28,0,0.0,28,0,33943.28437255559,10.857142857142858,0.052838139671453066
718,12,0,0.0,12,0,0.0,12.75,0.056442280377768404
719,45,3,0.06666666666666667,42,0,260089.55792499508,17.42222222222222,0.0648687014895227
720,15,1,0.06666666666666667,14,0,146386.25160212404,10.733333333333333,0.05772531539697919
721,23,1,0.043478260869565216,22,0,517197.1556288948,21.17391304347826,0.06001935905670893
722,21,0,0.0,21,0,39961.883321889036,14.666666666666666,0.06050601441960251
723,22,3,0.13636363636363635,19,0,66788.77136384377,10.909090909090908,0.052527215178766996
724,16,1,0.0625,15,0,49469.88792153345,16.25,0.06041825713207473
725,12,2,0.16666666666666666,10,0,59733.068755535875,13.833333333333334,0.05917561835740046
726,14,1,0.07142857142857142,13,0,0.0,8.714285714285714,0.05403999291296032
727,15,1,0.06666666666666667,14,0,16975.350370847496,11.333333333333334,0.05094080557191016
728,20,1,0.05,19,0,10779.89514240035,14.75,0.06331799723119179
729,16,0,0.0,16,0,268921.3411577583,16.5625,0.06465250155340088
730,17,0,0.0,17,0,2875.8934040184795,9.647058823529411,0.04544725032038156
731,19,4,0.21052631578947367,15,0,302568.6193570688,12.894736842105264,0.06779001362741847
732,24,2,0.08333333333333333,22,0,50678.85099877131,9.166666666666666,0.03957760035764032
733,11,1,0.09090909090909091,10,0,2238.8128623868843,19.90909090909091,0.03830846679634628
734,11,0,0.0,11,0,0.0,11.454545454545455,0.04394560957917049
735,25,1,0.04,24,0,101379.4760399403,14.36,0.05766729609727422
736,44,5,0.11363636363636363,39,0,200297.08939439684,14.113636363636363,0.05781434831100658
737,21,1,0.047619047619047616,20,0,112605.43445681386,22.61904761904762,0.05959160710860485
738,22,2,0.09090909090909091,20,0,28555.630861439757,18.318181818181817,0.08008198138217447
739,31,2,0.06451612903225806,29,0,405.0275357288147,12.096774193548388,0.05140773368691057
740,18,1,0.05555555555555555,17,0,309077.705317884,17.166666666666668,0.06882263014450773
741,34,2,0.058823529411764705,32,0,50016.52526951637,14.382352941176471,0.07051558128012728
742,14,0,0.0,14,0,59659.14571671196,24.357142857142858,0.06506579460905881
743,13,1,0.07692307692307693,12,0,114789.02646425602,20.23076923076923,0.06858722600900499
744,20,0,0.0,20,0,595.7539026001233,9.55,0.04647597996964116
745,36,2,0.05555555555555555,34,0,214076.6017008213,14.833333333333334,0.059859259301338334
746,16,1,0.0625,15,0,92071.22810571782,15.875,0.07645670351017535
747,12,2,0.16666666666666666,10,0,7735.7606990064005,14.25,0.07623147829138134
748,30,5,0.16666666666666666,25,0,121598.1929633264,13.4,0.07284908267559345
749,12,1,0.08333333333333333,11,0,0.0,8.416666666666666,0.05460180403755985
750,23,0,0.0,23,0,285216.30776205985,13.043478260869565,0.04679999004382516
751,12,1,0.08333333333333333,11,0,162113.50769133042,13.416666666666666,0.050734087661493336
752,15,0,0.0,15,0,103726.69889689279,17.8,0.06005853080650391
753,25,4,0.16,21,0,122882.29737043758,10.44,0.04440001141600117
754,15,2,0.13333333333333333,13,0,21003.890530997167,13.266666666666667,0.069649487311977
755,18,1,0.05555555555555555,17,0,28513.95654182719,14.61111111111111,0.0694250904723889
756,23,2,0.08695652173913043,21,0,7519.883254519739,16.52173913043478,0.0515304101789494
757,16,3,0.1875,13,0,37595.35604726301,14.3125,0.07070273110521426
758,19,0,0.0,19,0,18471.056212183616,15.947368421052632,0.08431089348906898
759,17,2,0.11764705882352941,15,0,464.63804609849706,9.882352941176471,0.051755922853023044
760,26,0,0.0,26,0,750494.6573983792,10.076923076923077,0.05261283881580011
761,15,0,0.0,15,0,374.0513827637514,14.6,0.058043837130767086
762,25,2,0.08,23,0,99447.87673770735,13.08,0.05102053361449453
763,20,1,0.05,19,0,81752.58272933675,14.95,0.05757534650882619
764,21,2,0.09523809523809523,19,0,10374.421356764362,15.666666666666666,0.05931900788629661
765,17,1,0.058823529411764705,16,0,1.411764705882353,13.0,0.05277851678531903
766,29,4,0.13793103448275862,25,0,192238.73464906978,12.068965517241379,0.06724514193098444
767,11,4,0.36363636363636365,7,0,0.2727272727272727,13.181818181818182,0.06763335201111838
768,19,2,0.10526315789473684,17,0,46699.019963273604,16.473684210526315,0.07849499517095615
769,12,1,0.08333333333333333,11,0,502642.99068967486,33.75,0.07474726961283319
770,23,5,0.21739130434782608,18,0,611300.840450254,14.695652173913043,0.054384043432211315
771,11,1,0.09090909090909091,10,0,0.0,11.0,0.0620324395898314
772,28,5,0.17857142857142858,23,0,52157.44071841853,17.678571428571427,0.07628189814900818
773,17,1,0.058823529411764705,16,0,4136.941176470588,13.470588235294118,0.07782486205552946
774,16,0,0.0,16,0,53587.62607598305,16.4375,0.07341978786397099
775,20,3,0.15,17,0,87116.74005073468,24.9,0.06623441106048991
776,16,1,0.0625,15,0,4.011904761904764,10.625,0.06433520981015223
777,11,2,0.18181818181818182,9,0,124961.83065023957,22.818181818181817,0.06841082537258916
778,15,0,0.0,15,0,215417.2613426102,14.6,0.07543957457678566
779,12,3,0.25,9,0,34031.10937359225,17.166666666666668,0.054104221506414106
780,23,2,0.08695652173913043,21,0,71500.2220254338,14.869565217391305,0.05694480358238957
781,20,0,0.0,20,0,47965.49625623801,11.45,0.05108334128765957
782,14,3,0.21428571428571427,11,0,6236.127991392312,9.285714285714286,0.05677188935920406
783,19,4,0.21052631578947367,15,0,96.35868039361277,10.68421052631579,0.05716754587059544
784,17,1,0.058823529411764705,16,0,168916.9172370789,14.117647058823529,0.07560139462906419
785,45,4,0.08888888888888889,41,0,891890.6338006104,13.11111111111111,0.05810357204285266
786,15,2,0.13333333333333333,13,0,22253.741586917233,9.466666666666667,0.0578124362626699
787,15,0,0.0,15,0,59518.4347484723,29.533333333333335,0.06930261388937242
788,14,3,0.21428571428571427,11,0,0.0,11.785714285714286,0.06046657519301853
789,15,1,0.06666666666666667,14,0,0.0,5.6,0.04320144916326201
790,16,2,0.125,14,0,0.013157894736842105,8.6875,0.0434932582370847
791,27,3,0.1111111111111111,24,0,84930.20156325155,11.185185185185185,0.045541058065980806
792,15,1,0.06666666666666667,14,0,7450.98713463591,9.666666666666666,0.05896586973723358
793,26,3,0.11538461538461539,23,0,31598.77023054008,15.26923076923077,0.056713417661487714
794,21,0,0.0,21,0,96693.8393385077,14.952380952380953,0.05398593230514606
795,30,5,0.16666666666666666,25,0,213839.8889852349,23.2,0.0721821750427705
796,36,4,0.1111111111111111,32,0,102785.97959691372,16.72222222222222,0.06503580308301343
797,17,1,0.058823529411764705,16,0,629.3047651970093,16.647058823529413,0.06692219180468763
798,16,1,0.0625,15,0,88643.04953960376,16.4375,0.07544005985655156
799,20,1,0.05,19,0,9009.094640634561,11.6,0.059675169620438916
800,16,2,0.125,14,0,191641.22749002947,15.125,0.06433235128408771
801,24,2,0.08333333333333333,22,0,354082.60931276117,20.666666666666668,0.06318933594687129
802,18,2,0.1111111111111111,16,0,106731.80527383261,11.444444444444445,0.07871057934326017
803,20,4,0.2,16,0,8822.041270732125,10.05,0.03925157313845555
804,14,3,0.21428571428571427,11,0,9625.859096521206,9.928571428571429,0.051786789236073
805,17,1,0.058823529411764705,16,0,27921.0794090611,12.941176470588236,0.054955574403859134
806,12,1,0.08333333333333333,11,0,163814.0,10.583333333333334,0.05684206929018429
807,20,2,0.1,18,0,173277.0262995597,15.2,0.051503874145323494
808,14,0,0.0,14,0,7567.838753260242,13.285714285714286,0.08132689907694983
809,12,5,0.4166666666666667,7,0,2.306547619047619,17.416666666666668,0.06908410001574307
810,15,0,0.0,15,0,57568.3992036292,15.0,0.07424861807993137
811,13,0,0.0,13,0,231.25299096622945,11.615384615384615,0.03343780558262378
812,15,1,0.06666666666666667,14,0,33874.44306703405,9.666666666666666,0.056076401814468164
813,12,1,0.08333333333333333,11,0,46864.0,10.166666666666666,0.06561622440331781
814,18,5,0.2777777777777778,13,0,213652.31301838715,15.944444444444445,0.06449421060995668
815,14,0,0.0,14,0,30954.13206946958,14.785714285714286,0.07002738170159632
816,24,5,0.20833333333333334,19,0,232896.8353913381,14.0,0.046652219294215924
817,18,1,0.05555555555555555,17,0,14990.175233243644,12.722222222222221,0.06213096654880985
818,24,3,0.125,21,0,16338.915951729774,17.291666666666668,0.07085354563264823
819,18,1,0.05555555555555555,17,0,0.05555555555555555,13.944444444444445,0.05330078786902403
820,17,1,0.058823529411764705,16,0,29589.315740865473,11.470588235294118,0.05050130143868196
821,23,1,0.043478260869565216,22,0,36042.357777111,15.173913043478262,0.05693501678962694
822,17,2,0.11764705882352941,15,0,4258.253288003276,15.529411764705882,0.06312923760915223
823,14,3,0.21428571428571427,11,0,155809.00528898765,16.142857142857142,0.0716987127718557
824,16,0,0.0,16,0,9340.125306984182,16.6875,0.05604737609578139
825,12,0,0.0,12,0,273192.5800266728,17.333333333333332,0.05866637412475486
826,20,3,0.15,17,0,165076.57031376517,9.95,0.04221397266608958
827,13,2,0.15384615384615385,11,0,0.15384615384615385,10.615384615384615,0.05139263330734009
828,12,0,0.0,12,0,67835.18117241525,19.25,0.06060004004304568
829,21,0,0.0,21,0,6147.693615936742,13.285714285714286,0.05824224741252217
830,15,3,0.2,12,0,191142.1568395185,18.4,0.0568168778198
831,16,0,0.0,16,0,4439.473067700129,12.75,0.04441811686479515
832,31,5,0.16129032258064516,26,0,1512.664516129032,12.290322580645162,0.043919464483753036
833,15,3,0.2,12,0,12153.89099390881,16.8,0.07897382456406296
834,21,1,0.047619047619047616,20,0,14426.274633090505,12.857142857142858,0.07682544331024503
835,14,2,0.14285714285714285,12,0,47011.45545545414,8.642857142857142,0.05784516488343666
836,14,2,0.14285714285714285,12,0,424064.68256716616,20.142857142857142,0.06977893596442006
837,19,1,0.05263157894736842,18,0,86624.98443777933,11.0,0.05138668003081736
838,28,4,0.14285714285714285,24,0,254825.65575497385,11.107142857142858,0.05235627929187856
839,21,4,0.19047619047619047,17,0,40209.20503663861,12.380952380952381,0.0666313511121707
840,25,3,0.12,22,0,125178.11265253667,17.4,0.06374085169180503
841,11,3,0.2727272727272727,8,0,0.0,16.363636363636363,0.05774480694514703
842,20,2,0.1,18,0,14887.20015490606,17.35,0.07204801376670374
843,19,2,0.10526315789473684,17,0,0.0,10.263157894736842,0.05798969377653581
844,23,4,0.17391304347826086,19,0,65682.9510618032,15.391304347826088,0.05928582310218898
845,30,3,0.1,27,0,54471.0277695394,12.133333333333333,0.05104513015924232
846,15,2,0.13333333333333333,13,0,0.0,10.466666666666667,0.044955529898690054
847,16,1,0.0625,15,0,42100.25742513844,18.6875,0.0715158923024595
848,20,3,0.15,17,0,4022.029272043942,14.0,0.06319012156497511
849,19,3,0.15789473684210525,16,0,146957.85827541313,11.473684210526315,0.06659367338134757
850,17,0,0.0,17,0,79108.77939140928,20.352941176470587,0.06828108373071086
851,19,2,0.10526315789473684,17,0,53159.170161450194,12.263157894736842,0.06779258907831534
852,25,4,0.16,21,0,52310.88936768438,15.08,0.04872735026474786
853,23,2,0.08695652173913043,21,0,143071.846929869,17.608695652173914,0.061212302185072176
854,12,2,0.16666666666666666,10,0,330905.15167452145,17.916666666666668,0.08864628012264332
855,15,1,0.06666666666666667,14,0,83763.19119272452,18.8,0.08080130373521086
856,15,0,0.0,15,0,526439.5525547244,18.466666666666665,0.07680638384803992
857,13,2,0.15384615384615385,11,0,2377.5575542609354,14.23076923076923,0.0850493527229065
858,17,0,0.0,17,0,49409.885817920534,23.352941176470587,0.0727181499112667
859,12,1,0.08333333333333333,11,0,0.0,10.083333333333334,0.04168722613813295
860,22,1,0.045454545454545456,21,0,318209.1491415016,17.727272727272727,0.06624503644856272
861,20,4,0.2,16,0,353259.9406564905,20.65,0.07475172396170413
862,26,5,0.19230769230769232,21,0,50050.78622363197,10.73076923076923,0.06337954527934009
863,20,1,0.05,19,0,22844.78800978054,12.65,0.05858304367452753
864,17,3,0.17647058823529413,14,0,413290.8841191638,20.941176470588236,0.08877345628516838
865,17,3,0.17647058823529413,14,0,93463.25732724695,15.470588235294118,0.05898191489935806
866,25,2,0.08,23,0,20779.50108968091,12.48,0.0540127331865523
867,19,2,0.10526315789473684,17,0,79717.66985417805,17.789473684210527,0.060175891128553614
868,11,4,0.36363636363636365,7,0,1896.9614245800394,17.818181818181817,0.08435495596669956
869,30,0,0.0,30,0,37260.299729056394,11.766666666666667,0.05014890564986332
870,32,3,0.09375,29,0,92461.33810862935,10.4375,0.051281092641901
871,17,2,0.11764705882352941,15,0,309421.7114194604,14.647058823529411,0.05357205215439585
872,12,2,0.16666666666666666,10,0,0.0,8.0,0.05749640172400832
873,20,3,0.15,17,0,25193.675741500796,13.8,0.06621172051587051
874,19,3,0.15789473684210525,16,0,41353.620395134945,17.210526315789473,0.056401116076510105
875,15,0,0.0,15,0,82229.90106195581,16.266666666666666,0.07328553253508505
876,26,2,0.07692307692307693,24,0,43975.086037058165,8.307692307692308,0.03318521995616831
877,12,0,0.0,12,0,256852.14409379914,13.916666666666666,0.07362881358320776
878,19,2,0.10526315789473684,17,0,10970.016075738344,9.736842105263158,0.0642221889807581
879,11,0,0.0,11,0,0.0,16.545454545454547,0.04549969135977591
880,14,1,0.07142857142857142,13,0,83451.08825398124,12.785714285714286,0.08272827247386524
881,27,5,0.18518518518518517,22,0,263845.16868127364,13.148148148148149,0.07202464714248015
882,14,1,0.07142857142857142,13,0,6698.0,10.714285714285714,0.0690220116539396
883,26,5,0.19230769230769232,21,0,61056.799900936945,12.23076923076923,0.04257304483309
884,15,0,0.0,15,0,11704.053822764707,15.466666666666667,0.08078182870663145
885,25,1,0.04,24,0,77972.93938057589,17.44,0.08299912651251592
886,20,0,0.0,20,0,0.0,11.65,0.04774512563156597
887,20,0,0.0,20,0,97361.70796542463,19.7,0.07122301114308761
888,16,0,0.0,16,0,6.625,10.25,0.05065217579532921
889,12,0,0.0,12,0,104361.88818391075,20.0,0.062701122492724
890,11,0,0.0,11,0,91790.86122476764,14.545454545454545,0.06340264808478088
891,15,0,0.0,15,0,32930.94751599308,12.6,0.0635344986449624
892,11,2,0.18181818181818182,9,0,825396.2289805897,25.363636363636363,0.06034709559947624
893,15,0,0.0,15,0,7855.808397361205,12.466666666666667,0.05208193332842128
894,12,1,0.08333333333333333,11,0,30259.26848305506,14.5,0.0701577083449545
895,22,0,0.0,22,0,69955.64988187717,14.318181818181818,0.06696480186135821
896,19,2,0.10526315789473684,17,0,36689.272806483226,9.947368421052632,0.062246013739871764
897,23,1,0.043478260869565216,22,0,4076.9565217391305,9.608695652173912,0.047874072112705286
898,13,2,0.15384615384615385,11,0,130574.28947683972,14.153846153846153,0.07737390216446703
899,22,3,0.13636363636363635,19,0,0.0,11.863636363636363,0.056333683366031034
900,13,0,0.0,13,0,84205.32792877933,13.923076923076923,0.053885555252119785
901,22,1,0.045454545454545456,21,0,127200.6539430216,15.409090909090908,0.06186714106078734
902,12,0,0.0,12,0,0.16666666666666666,8.833333333333334,0.04317252103398361
903,16,2,0.125,14,0,41471.04254671611,12.875,0.06701441453634806
904,32,3,0.09375,29,0,93341.34306142267,14.0,0.07667511490533736
905,54,9,0.16666666666666666,45,0,155238.67874366711,12.648148148148149,0.061285730214301753
906,11,1,0.09090909090909091,10,0,0.0,8.0,0.05411793220685281
907,15,0,0.0,15,0,6251.666666666667,9.866666666666667,0.05725008103251792
908,29,3,0.10344827586206896,26,0,139433.78050836673,17.06896551724138,0.06537214818195272
909,19,1,0.05263157894736842,18,0,21.473009446693666,14.31578947368421,0.03641514705171977
910,20,2,0.1,18,0,1339.3857142847955,13.45,0.055329190521204406
911,15,0,0.0,15,0,60702.412400542846,12.666666666666666,0.038460964939167334
912,35,4,0.11428571428571428,31,0,102500.05584493595,11.971428571428572,0.060821875369416266
913,23,2,0.08695652173913043,21,0,81079.62952768737,15.08695652173913,0.06284908360762245
914,22,2,0.09090909090909091,20,0,133060.36983733394,14.727272727272727,0.07017944036382757
915,28,3,0.10714285714285714,25,0,13596.48104556608,14.821428571428571,0.050785249066778594
916,19,0,0.0,19,0,21220.357733902856,10.736842105263158,0.05154067517969413
917,13,3,0.23076923076923078,10,0,10819.23076923077,7.923076923076923,0.05024182152421312
918,26,2,0.07692307692307693,24,0,66440.5792560361,13.692307692307692,0.06301735771321568
919,22,1,0.045454545454545456,21,0,56338.226652767466,15.863636363636363,0.07233845583046289
920,29,2,0.06896551724137931,27,0,5691.291426933292,9.931034482758621,0.04642398506821364
921,22,1,0.045454545454545456,21,0,2131.181818181818,12.909090909090908,0.07100837855127767
922,13,3,0.23076923076923078,10,0,7841.921117394795,13.692307692307692,0.06446060656428364
923,20,2,0.1,18,0,65675.64164361102,10.65,0.04631397284883071
924,13,1,0.07692307692307693,12,0,0.0,12.538461538461538,0.06785838452930086
925,26,1,0.038461538461538464,25,0,76075.98049404552,11.192307692307692,0.05485873043320569
926,21,1,0.047619047619047616,20,0,48045.61727738634,9.666666666666666,0.056957496957480765
927,18,3,0.16666666666666666,15,0,180287.1466638241,11.555555555555555,0.051492889895996846
928,13,1,0.07692307692307693,12,0,38630.857748820534,15.692307692307692,0.08254426552664647
929,14,0,0.0,14,0,6570.529528188864,13.0,0.048780781993366426
930,13,0,0.0,13,0,172521.38133988495,18.153846153846153,0.051490979402712383
931,27,1,0.037037037037037035,26,0,157868.2589994304,11.333333333333334,0.06013521520525158
932,85,4,0.047058823529411764,81,0,82811.41334424094,16.352941176470587,0.05621939346955946
933,19,3,0.15789473684210525,16,0,27427.845055357022,12.736842105263158,0.059389906901040124
934,15,1,0.06666666666666667,14,0,8753.666213895543,11.6,0.05125994243917374
935,26,2,0.07692307692307693,24,0,50238.922014931646,8.153846153846153,0.03408124042428928
936,22,2,0.09090909090909091,20,0,76447.76096809245,14.045454545454545,0.04752157683119691
937,21,3,0.14285714285714285,18,0,125758.44513620588,23.428571428571427,0.07776161143433609
938,15,1,0.06666666666666667,14,0,51334.8009393171,16.466666666666665,0.06677441477554122
939,17,3,0.17647058823529413,14,0,1529.781096394588,10.647058823529411,0.06150756102243748
940,12,0,0.0,12,0,20569.491787052095,19.5,0.06598044530419613
941,13,2,0.15384615384615385,11,0,22610.487170102835,15.76923076923077,0.07454796688069099
942,23,3,0.13043478260869565,20,0,135396.2336375251,17.82608695652174,0.06073796154064176
943,12,3,0.25,9,0,188116.61944378077,20.75,0.07784695037929243
944,19,4,0.21052631578947367,15,0,6.266081871345033,17.63157894736842,0.07188249880501985
945,15,2,0.13333333333333333,13,0,1562.7999999999997,18.733333333333334,0.08166990793025539
946,14,1,0.07142857142857142,13,0,149616.47491120355,9.857142857142858,0.04815360776334393
947,13,4,0.3076923076923077,9,0,19.594215190257007,15.384615384615385,0.0773000621873711
948,13,2,0.15384615384615385,11,0,220307.56365100495,18.923076923076923,0.07904667908762247
949,29,1,0.034482758620689655,28,0,41074.018399207474,14.724137931034482,0.06324058299318094
950,36,2,0.05555555555555555,34,0,62467.52569894128,13.333333333333334,0.06610213313927048
951,19,1,0.05263157894736842,18,0,42619.01765077792,11.842105263157896,0.05096627047667345
952,13,1,0.07692307692307693,12,0,1233040.2358186566,19.615384615384617,0.07457607180911102
953,29,2,0.06896551724137931,27,0,99397.76475111918,12.379310344827585,0.05943819847046328
954,15,3,0.2,12,0,58061.01357844141,11.066666666666666,0.04378088176687531
955,31,4,0.12903225806451613,27,0,336661.3983171074,23.129032258064516,0.08734186805609839
956,26,0,0.0,26,0,455.3850551165179,12.615384615384615,0.057457821491286185
957,26,0,0.0,26,0,135448.18931207692,16.884615384615383,0.06329507166658536
958,16,0,0.0,16,0,48488.132361134136,12.5625,0.05948456045894299
959,23,0,0.0,23,0,191479.0971981523,13.695652173913043,0.061067722969534055
960,12,4,0.3333333333333333,8,0,2865.568097392374,13.0,0.0784054010989546
961,19,2,0.10526315789473684,17,0,1234.439788466381,10.947368421052632,0.05719332837545037
962,15,2,0.13333333333333333,13,0,0.0,10.866666666666667,0.04678503414584609
963,21,2,0.09523809523809523,19,0,40715.42498906913,15.095238095238095,0.08512252405315886
964,17,2,0.11764705882352941,15,0,1619.6788658063226,11.823529411764707,0.05201463255282256
965,27,3,0.1111111111111111,24,0,6448.676238934126,14.481481481481481,0.05022017829088675
966,27,1,0.037037037037037035,26,0,40669.98282326567,17.74074074074074,0.07233128363896867
967,22,1,0.045454545454545456,21,0,2135.8257575757575,6.363636363636363,0.04623178066213077
968,26,3,0.11538461538461539,23,0,108277.08995726635,16.26923076923077,0.07419648518801573
969,12,1,0.08333333333333333,11,0,10003.744886929491,19.416666666666668,0.08145764742041484
970,12,1,0.08333333333333333,11,0,68484.52757382083,16.5,0.07945424980407681
971,19,3,0.15789473684210525,16,0,74839.22352493076,9.421052631578947,0.04141036592578584
972,34,1,0.029411764705882353,33,0,119615.42283330287,14.558823529411764,0.05379966800731945
973,15,2,0.13333333333333333,13,0,47583.70675415529,9.533333333333333,0.03625372591615992
974,17,0,0.0,17,0,3410.9821059172887,14.411764705882353,0.05922031944202738
975,19,2,0.10526315789473684,17,0,26505.156188188896,19.31578947368421,0.08095004919461675
976,39,1,0.02564102564102564,38,0,32206.201615598293,13.23076923076923,0.052932583677635404
977,38,5,0.13157894736842105,33,0,32496.452342806715,14.657894736842104,0.062725929214325
978,15,1,0.06666666666666667,14,0,49972.8000824286,15.133333333333333,0.05635355170409492
979,11,1,0.09090909090909091,10,0,5.090909090909091,12.272727272727273,0.057696549338748376
980,23,3,0.13043478260869565,20,0,108638.4391525345,21.08695652173913,0.0847084715521672
981,21,3,0.14285714285714285,18,0,118608.56336824081,15.19047619047619,0.0646146091643517
982,25,3,0.12,22,0,67798.66318459282,19.36,0.08260434740847272
983,15,1,0.06666666666666667,14,0,242631.31837291396,8.6,0.03278647344044707
984,23,3,0.13043478260869565,20,0,3634.5408846734995,13.173913043478262,0.054199904782508336
985,27,3,0.1111111111111111,24,0,99497.65019377966,14.25925925925926,0.04996711748438557
986,16,1,0.0625,15,0,97893.38183287549,19.25,0.0758456981152473
987,21,2,0.09523809523809523,19,0,5973.420688494743,10.047619047619047,0.06553846881837731
988,24,2,0.08333333333333333,22,0,62180.95351067771,12.166666666666666,0.06849094727694861
989,12,2,0.16666666666666666,10,0,0.0,12.416666666666666,0.08387405870275426
990,28,5,0.17857142857142858,23,0,3955.0445503532965,10.214285714285714,0.048822818436596006
991,11,1,0.09090909090909091,10,0,312210.02972102544,18.09090909090909,0.08729989563834638
992,12,1,0.08333333333333333,11,0,7461.572956191102,12.083333333333334,0.04446165783201712
993,31,0,0.0,31,0,445768.04733869835,15.451612903225806,0.06108864674145978
994,18,2,0.1111111111111111,16,0,56182.78402857067,14.222222222222221,0.06896340374242528
995,21,0,0.0,21,0,10156.298546261416,9.0,0.042308419938143244
996,16,1,0.0625,15,0,14477.234475507907,8.625,0.06136294299408394
997,15,1,0.06666666666666667,14,0,7887.194275387609,14.4,0.06422050010043166
998,15,3,0.2,12,0,107994.38483064441,14.533333333333333,0.04734080900546747
999,26,2,0.07692307692307693,24,0,66180.43483792887,10.423076923076923,0.06632654715614947
1000,17,3,0.17647058823529413,14,0,912195.5946273692,10.823529411764707,0.04686212208424065
1001,16,1,0.0625,15,0,5293.189847989312,10.5625,0.04850278431651135
1002,23,0,0.0,23,0,392822.4073638119,15.0,0.06701236113902363
1003,16,1,0.0625,15,0,14323.978745643519,16.4375,0.0817059941540383
1004,22,3,0.13636363636363635,19,0,205288.46835071288,15.272727272727273,0.05740763551831837
1005,13,1,0.07692307692307693,12,0,30999.794138724275,10.23076923076923,0.050109143335039526
1006,14,0,0.0,14,0,28438.618822740948,14.428571428571429,0.04688160310858041
1007,33,1,0.030303030303030304,32,0,167997.6989747394,13.333333333333334,0.056726572474070786
1008,18,5,0.2777777777777778,13,0,184165.7267360604,9.277777777777779,0.043996589505828396
1009,25,1,0.04,24,0,2631.4240000007912,9.8,0.051237313194730315
1010,13,1,0.07692307692307693,12,0,61275.53846153846,15.384615384615385,0.0664044308277064
1011,11,2,0.18181818181818182,9,0,12721.682910907724,9.181818181818182,0.06987002529247437
1012,16,1,0.0625,15,0,0.9852272727272727,13.8125,0.0618346586867428
1013,17,0,0.0,17,0,24152.07207088911,17.176470588235293,0.07287911557695591
1014,24,3,0.125,21,0,83428.67248958832,13.75,0.07034432297639785
1015,16,0,0.0,16,0,327442.1788634033,13.4375,0.06581339212213018
1016,32,1,0.03125,31,0,47996.30601406806,15.875,0.06318289011636263
1017,17,2,0.11764705882352941,15,0,0.058823529411764705,8.411764705882353,0.052995571599394505
1018,14,1,0.07142857142857142,13,0,8432.752976683236,18.5,0.08454077385444307
1019,26,2,0.07692307692307693,24,0,12190.84717689154,12.23076923076923,0.046969142232591195
1020,21,2,0.09523809523809523,19,0,102287.79717151712,13.238095238095237,0.043302326489104336
1021,19,1,0.05263157894736842,18,0,11528.419373794548,11.894736842105264,0.05841681764626834
1022,13,1,0.07692307692307693,12,0,5440.996349998647,11.307692307692308,0.05166475370386238
1023,17,2,0.11764705882352941,15,0,265444.3964686556,13.176470588235293,0.06612392718582806
1024,13,1,0.07692307692307693,12,0,17587.046137216443,17.23076923076923,0.051665186189571576
1025,18,3,0.16666666666666666,15,0,0.0,13.277777777777779,0.05176929844915952
1026,12,1,0.08333333333333333,11,0,0.0,15.5,0.055821820141036003
1027,21,1,0.047619047619047616,20,0,2239.2380952380954,12.0,0.06485124159226571
1028,39,4,0.10256410256410256,35,0,3152.9704623908756,13.512820512820513,0.06776670919894838
1029,18,2,0.1111111111111111,16,0,60720.970568391574,9.5,0.06659425795088782
1030,14,0,0.0,14,0,0.0,13.928571428571429,0.05332285525368758
1031,18,4,0.2222222222222222,14,0,35.34472491564842,10.944444444444445,0.047413019360020216
1032,30,2,0.06666666666666667,28,0,231721.867337346,14.2,0.07068082743710459
1033,23,5,0.21739130434782608,18,0,66485.32931709077,14.26086956521739,0.05123258587202247
1034,22,1,0.045454545454545456,21,0,74624.08770726969,6.545454545454546,0.0397504758159859
1035,13,0,0.0,13,0,68903.02237810743,15.846153846153847,0.04807700389540785
1036,32,3,0.09375,29,0,27787.513603286057,6.78125,0.041026750242262294
1037,16,3,0.1875,13,0,156725.92636003153,27.5625,0.07037111685232299
1038,23,3,0.13043478260869565,20,0,513162.0413506044,16.130434782608695,0.05940344972349251
1039,13,2,0.15384615384615385,11,0,14147.046333497943,10.461538461538462,0.053424928246480645
1040,15,2,0.13333333333333333,13,0,125261.26118111161,21.8,0.10306253251393734
1041,12,1,0.08333333333333333,11,0,106245.97724786015,16.0,0.06533660819641741
1042,17,1,0.058823529411764705,16,0,117419.53599268598,12.705882352941176,0.04640187548938343
1043,27,2,0.07407407407407407,25,0,47846.80357870194,5.37037037037037,0.037489813263328946
1044,17,3,0.17647058823529413,14,0,48.263234510573824,10.647058823529411,0.055341452771733454
1045,11,1,0.09090909090909091,10,0,25211.50430780901,15.818181818181818,0.06835467216026417
1046,15,2,0.13333333333333333,13,0,34729.41451826938,15.733333333333333,0.06980873470210773
1047,14,1,0.07142857142857142,13,0,2234.159504161414,18.785714285714285,0.06967794338015405
1048,17,0,0.0,17,0,33194.72448469663,16.235294117647058,0.061146763368826684
1049,21,0,0.0,21,0,147885.10293337316,17.523809523809526,0.0701783557722248
1050,20,0,0.0,20,0,215140.43953071395,22.4,0.07228479831425638
1051,10,1,0.1,9,0,17364.525406958266,13.3,0.08463417103341019
1052,14,0,0.0,14,0,4601.872349111009,24.071428571428573,0.08413916939967774
1053,13,0,0.0,13,0,42486.66736332735,11.846153846153847,0.05795495971588931
1054,11,0,0.0,11,0,594079.0344535375,10.0,0.0640341932034163
1055,32,2,0.0625,30,0,49922.902642702524,11.125,0.05788083532002172
1056,12,1,0.08333333333333333,11,0,1871.9872692560737,14.333333333333334,0.06546856557250906
1057,19,2,0.10526315789473684,17,0,30268.938361522214,7.578947368421052,0.03518981019567844
1058,12,2,0.16666666666666666,10,0,27356.398625677073,17.083333333333332,0.0440306593968107
1059,14,1,0.07142857142857142,13,0,0.0,10.5,0.06093382292451989
1060,18,0,0.0,18,0,33937.21979737768,11.666666666666666,0.04630348051721636
1061,14,1,0.07142857142857142,13,0,178.28571428571428,15.5,0.04900660589481479
1062,20,3,0.15,17,0,87334.5067590301,19.1,0.07521395538361833
1063,19,2,0.10526315789473684,17,0,144849.87215072947,18.736842105263158,0.06772566506993276
1064,14,1,0.07142857142857142,13,0,153401.63561755986,18.714285714285715,0.06599523689528436
1065,16,0,0.0,16,0,487740.6892889654,24.375,0.06696243955360029
1066,14,3,0.21428571428571427,11,0,151451.07806427832,19.785714285714285,0.07857466690914904
1067,12,0,0.0,12,0,7762.691150018116,13.333333333333334,0.05167240289751149
1068,13,2,0.15384615384615385,11,0,5917.803389632382,20.23076923076923,0.05736935711479515
1069,16,1,0.0625,15,0,111917.1013060631,17.0625,0.07030550713755135
1070,15,1,0.06666666666666667,14,0,5138.881107573042,13.133333333333333,0.07243314502309343
1071,12,1,0.08333333333333333,11,0,0.2638888888888889,11.083333333333334,0.0398405207690145
1072,23,3,0.13043478260869565,20,0,85955.7809814874,19.869565217391305,0.049893899933915006
1073,12,1,0.08333333333333333,11,0,360411.77285599196,23.25,0.09131124155762134
1074,15,5,0.3333333333333333,10,0,46745.84290488809,21.666666666666668,0.06906391618116038
1075,12,1,0.08333333333333333,11,0,95118.64201338828,13.583333333333334,0.05754001726759633
1076,32,3,0.09375,29,0,16774.257976235735,12.96875,0.06676606564311735
1077,13,2,0.15384615384615385,11,0,120507.55602148784,14.384615384615385,0.05868029597767055
1078,42,2,0.047619047619047616,40,0,178863.72533209468,16.023809523809526,0.06573559677735805
1079,16,1,0.0625,15,0,20962.610700351473,13.8125,0.06396091333821417
1080,13,1,0.07692307692307693,12,0,203079.5410600555,19.307692307692307,0.05479737341477252
1081,43,6,0.13953488372093023,37,0,365166.04004329554,14.465116279069768,0.07656874512521115
1082,17,0,0.0,17,0,147828.0314816411,17.705882352941178,0.07630009639678889
1083,12,2,0.16666666666666666,10,0,102008.64567418113,16.0,0.07330514419487368
1084,11,0,0.0,11,0,4917.927277279071,10.909090909090908,0.055713788075903097
1085,18,4,0.2222222222222222,14,0,21907.456591357437,7.555555555555555,0.057656921467031975
1086,12,2,0.16666666666666666,10,0,37471.800800249956,21.5,0.07882748790046117
1087,25,2,0.08,23,0,53549.68735821368,15.84,0.0661343822438093
1088,11,1,0.09090909090909091,10,0,16663.897770390293,7.454545454545454,0.04682765179425708
1089,21,0,0.0,21,0,87308.8314243647,17.904761904761905,0.05698741406586596
1090,19,1,0.05263157894736842,18,0,69570.1105561289,8.263157894736842,0.047625843644855996
1091,12,1,0.08333333333333333,11,0,15812.974877580913,12.833333333333334,0.05264687160525535
1092,15,2,0.13333333333333333,13,0,107720.05377756999,6.466666666666667,0.04696295506771984
1093,11,2,0.18181818181818182,9,0,1.2727272727272725,12.909090909090908,0.05323252214498587
1094,15,2,0.13333333333333333,13,0,42656.00150420413,16.6,0.0826257232195064
1095,16,0,0.0,16,0,11720.5,8.375,0.06446700827863822
1096,18,1,0.05555555555555555,17,0,135694.4790702063,14.88888888888889,0.05186481099658254
1097,16,0,0.0,16,0,0.0,14.75,0.05922840093516993
1098,13,0,0.0,13,0,147520.17657383715,18.615384615384617,0.07319756286305362
1099,21,1,0.047619047619047616,20,0,86441.32410072882,12.333333333333334,0.0492121795057196
1100,26,0,0.0,26,0,9827.451413569092,19.76923076923077,0.07443008565174174
1101,22,5,0.22727272727272727,17,0,7911.8888888869815,12.181818181818182,0.05897467173024873
1102,13,3,0.23076923076923078,10,0,0.0,6.153846153846154,0.05567810818806392
1103,12,2,0.16666666666666666,10,0,2000.4516087840857,14.75,0.08013169184189943
1104,16,1,0.0625,15,0,231473.2849283337,15.125,0.05607729054323764
1105,12,0,0.0,12,0,84870.50973999708,13.25,0.06599849576236408
1106,24,2,0.08333333333333333,22,0,187564.1565912546,19.375,0.06470451640003923
1107,19,3,0.15789473684210525,16,0,53025.88307012607,17.05263157894737,0.0645504829821089
1108,15,1,0.06666666666666667,14,0,49616.41299668859,13.666666666666666,0.0704316108318407
1109,28,2,0.07142857142857142,26,0,75701.825368801,14.035714285714286,0.0641998662462943
1110,12,1,0.08333333333333333,11,0,1736.8733063451893,13.083333333333334,0.07569072374397004
1111,17,1,0.058823529411764705,16,0,155220.90220925008,18.352941176470587,0.07184344978569188
1112,12,0,0.0,12,0,399059.98432469316,27.0,0.08841457472335697
1113,16,1,0.0625,15,0,32123.232308774954,12.0625,0.05613971911121894
1114,15,3,0.2,12,0,275947.80084502784,15.066666666666666,0.07340008846101309
1115,29,2,0.06896551724137931,27,0,30092.392041433654,8.793103448275861,0.05187719695612623
1116,12,1,0.08333333333333333,11,0,3907.1666666666665,9.25,0.03894398815648329
1117,13,2,0.15384615384615385,11,0,1.0989010989010988,12.461538461538462,0.03965791077946339
1118,14,0,0.0,14,0,0.8571428571428571,9.285714285714286,0.06307267625370772
1119,12,0,0.0,12,0,207290.17109267777,15.25,0.05919084127019136
1120,13,0,0.0,13,0,388511.0567203601,29.23076923076923,0.07957398493965978
1121,18,1,0.05555555555555555,17,0,122807.79264452557,21.944444444444443,0.08395787954878879
1122,13,1,0.07692307692307693,12,0,121701.51125527864,13.846153846153847,0.07500973118753537
1123,14,0,0.0,14,0,211741.69404487434,15.857142857142858,0.05857300248417848
1124,13,1,0.07692307692307693,12,0,0.0,7.6923076923076925,0.04132643780818428
1125,21,1,0.047619047619047616,20,0,864.9455732179116,11.333333333333334,0.06391648666015509
1126,27,7,0.25925925925925924,20,0,30367.98049460797,9.74074074074074,0.04122092998722466
1127,12,1,0.08333333333333333,11,0,10810.555519717067,13.75,0.052225830427490655
1128,11,0,0.0,11,0,10840.852743601901,12.636363636363637,0.05094934271041301
1129,19,0,0.0,19,0,684.631053127081,11.736842105263158,0.07437934747765385
1130,14,0,0.0,14,0,0.05714285714285714,8.428571428571429,0.048879911484764886
1131,16,0,0.0,16,0,192739.1974846788,13.625,0.07721860366696415
1132,24,2,0.08333333333333333,22,0,76337.8027724977,10.541666666666666,0.04476092438794522
1133,42,1,0.023809523809523808,41,0,188512.07399667028,14.523809523809524,0.07123111477260372
1134,55,4,0.07272727272727272,51,0,19444.785043125252,12.309090909090909,0.0623094187031475
1135,28,2,0.07142857142857142,26,0,46918.6328952314,10.607142857142858,0.058558320268758575
1136,17,0,0.0,17,0,0.0,7.823529411764706,0.044191403208579796
1137,10,1,0.1,9,0,0.0,15.2,0.0831849466126825
1138,14,0,0.0,14,0,8999.598214285714,12.571428571428571,0.058271581285878296
1139,23,1,0.043478260869565216,22,0,2145.8302281517967,12.391304347826088,0.0693949645691875
1140,12,2,0.16666666666666666,10,0,0.0,13.583333333333334,0.03577450963835865
1141,14,2,0.14285714285714285,12,0,8121.910751593476,27.5,0.06624707250302676
1142,12,3,0.25,9,0,32830.150511889944,14.416666666666666,0.07198537735297343
1143,12,3,0.25,9,0,322752.31694879185,18.083333333333332,0.07166398757683698
1144,11,0,0.0,11,0,5134.71239494498,16.181818181818183,0.0706375085391259
1145,27,4,0.14814814814814814,23,0,185258.80067132897,16.48148148148148,0.07767033449026968
1146,17,1,0.058823529411764705,16,0,4.508883041599363,9.647058823529411,0.052046485368122786
1147,22,0,0.0,22,0,269212.9371772788,13.545454545454545,0.06419258700745283
1148,27,0,0.0,27,0,38598.28865877832,12.62962962962963,0.06562665271776127
1149,22,1,0.045454545454545456,21,0,47058.70502227875,9.454545454545455,0.049910223524515865
1150,31,1,0.03225806451612903,30,0,44605.21924277937,14.483870967741936,0.05544503992650689
1151,24,2,0.08333333333333333,22,0,216.55701240097073,15.041666666666666,0.06400248733692705
1152,21,2,0.09523809523809523,19,0,54477.836167623434,13.19047619047619,0.057756066157876346
1153,14,1,0.07142857142857142,13,0,0.0,9.0,0.052637598003593515
1154,48,4,0.08333333333333333,44,0,19523.31293485174,12.604166666666666,0.05534627586900239
1155,14,2,0.14285714285714285,12,0,390091.7040666422,14.642857142857142,0.06912900147651506
1156,12,2,0.16666666666666666,10,0,19659.10214439605,15.916666666666666,0.06232571528844855
1157,11,1,0.09090909090909091,10,0,81617.32767881198,13.636363636363637,0.03931448225107378
1158,21,0,0.0,21,0,241829.64085680855,17.142857142857142,0.06577052244616252
1159,21,1,0.047619047619047616,20,0,5557.31121856737,5.095238095238095,0.042151936564821094
1160,14,0,0.0,14,0,305912.6522305665,19.5,0.06877305179879824
1161,12,0,0.0,12,0,3907.1666666666665,11.0,0.06262537969391818
1162,33,0,0.0,33,0,69813.3198653186,10.06060606060606,0.04891955270006893
1163,11,1,0.09090909090909091,10,0,89509.27272727272,14.272727272727273,0.039684094092423024
1164,21,2,0.09523809523809523,19,0,11280.485698885725,13.952380952380953,0.07725164753225679
1165,20,0,0.0,20,0,95990.2588080234,14.05,0.04494734795264121
1166,19,5,0.2631578947368421,14,0,92518.9947350159,18.263157894736842,0.0687682022665418
1167,11,2,0.18181818181818182,9,0,62945.49912650676,30.454545454545453,0.07580341070054523
1168,13,1,0.07692307692307693,12,0,50228.893192435455,10.692307692307692,0.03570940086952418
1169,17,1,0.058823529411764705,16,0,3648.242060223593,7.0,0.04022423381816302
1170,11,1,0.09090909090909091,10,0,61558.05693107924,8.818181818181818,0.028407494440199688
1171,11,0,0.0,11,0,19856.542554736036,8.545454545454545,0.06456177138724785
1172,11,2,0.18181818181818182,9,0,50857.47008879918,16.90909090909091,0.07782241288782046
1173,12,3,0.25,9,0,10278.959415030662,19.833333333333332,0.07805633284546344
1174,30,4,0.13333333333333333,26,0,12545.818220361549,13.3,0.06251845437659992
1175,17,2,0.11764705882352941,15,0,36697.079578330326,13.411764705882353,0.06016013925479634
1176,13,0,0.0,13,0,34620.43711906565,13.76923076923077,0.06307661495650776
1177,22,1,0.045454545454545456,21,0,42654.68898775916,10.181818181818182,0.04248976177092384
1178,22,3,0.13636363636363635,19,0,111481.75053311404,24.045454545454547,0.07837218779089862
1179,17,3,0.17647058823529413,14,0,50543.27166806628,11.352941176470589,0.06117063060751426
1180,12,2,0.16666666666666666,10,0,54034.96925311614,20.25,0.07300989295189471
1181,13,0,0.0,13,0,63881.895441937464,7.384615384615385,0.030107730852890553
1182,31,2,0.06451612903225806,29,0,52476.290741763354,11.290322580645162,0.053940595718120266
1183,16,1,0.0625,15,0,0.0,7.875,0.035526760898965073
1184,18,3,0.16666666666666666,15,0,194657.33769129612,18.27777777777778,0.07874675515483841
1185,15,2,0.13333333333333333,13,0,23117.184749568278,14.266666666666667,0.05449470609542659
1186,26,3,0.11538461538461539,23,0,0.0,7.346153846153846,0.041547484769236045
1187,17,1,0.058823529411764705,16,0,5.647058823529412,15.235294117647058,0.06540953043943477
1188,16,1,0.0625,15,0,52931.456920572615,28.0,0.07878378102151912
1189,15,1,0.06666666666666667,14,0,36840.175849567786,11.6,0.05965275362720549
1190,17,3,0.17647058823529413,14,0,354276.2092730166,8.235294117647058,0.04571096856385404
1191,14,1,0.07142857142857142,13,0,1444.0182544794623,18.928571428571427,0.07291702517975382
1192,11,1,0.09090909090909091,10,0,214816.9090909091,8.545454545454545,0.05219854214044413
1193,15,2,0.13333333333333333,13,0,681518.9844325937,14.133333333333333,0.056153280580720125
1194,21,3,0.14285714285714285,18,0,2685.848934737461,10.047619047619047,0.054726993127428826
1195,22,1,0.045454545454545456,21,0,1882.8193327220565,14.863636363636363,0.06232867782780474
1196,12,1,0.08333333333333333,11,0,148440.11060892083,16.0,0.0618273772949596
1197,12,1,0.08333333333333333,11,0,1668.941272453305,17.333333333333332,0.07452668917596966
1198,32,4,0.125,28,0,443803.3413175356,17.5625,0.07376512885339301
1199,17,1,0.058823529411764705,16,0,51810.39492248893,13.529411764705882,0.05212638078371129
1200,18,0,0.0,18,0,5434.246995005355,13.0,0.07156732187514857
1201,12,0,0.0,12,0,43211.10041777702,24.25,0.0938312602109568
1202,11,0,0.0,11,0,183029.60661688852,19.181818181818183,0.0907117139445869
1203,17,1,0.058823529411764705,16,0,83525.51223123657,16.823529411764707,0.08002866121654724
1204,14,1,0.07142857142857142,13,0,211991.31725484555,10.714285714285714,0.04914791831978057
1205,22,3,0.13636363636363635,19,0,23224.874199287136,16.454545454545453,0.055423833555566085
1206,11,1,0.09090909090909091,10,0,0.0,11.818181818181818,0.05598908842068964
1207,22,1,0.045454545454545456,21,0,23451.707884819873,17.0,0.060632373715417874
1208,13,0,0.0,13,0,3724.895144661311,11.384615384615385,0.054529078551368425
1209,15,1,0.06666666666666667,14,0,0.0,14.4,0.06443382252207065
1210,22,2,0.09090909090909091,20,0,4262.181818181818,10.5,0.06597140584474372
1211,48,1,0.020833333333333332,47,0,207000.4650447897,11.6875,0.05896232183270666
1212,17,3,0.17647058823529413,14,0,216652.88180737066,8.470588235294118,0.07631983226657857
1213,29,6,0.20689655172413793,23,0,54948.63190332065,13.344827586206897,0.06122279240317836
1214,11,0,0.0,11,0,0.0,10.636363636363637,0.024606148270669405
1215,16,1,0.0625,15,0,25033.257425910466,11.3125,0.06358579308083369
1216,30,2,0.06666666666666667,28,0,37562.536480128765,15.9,0.06989748946703388
1217,14,0,0.0,14,0,10758.611111108114,11.785714285714286,0.06418639501460802
1218,27,1,0.037037037037037035,26,0,47055.32778569362,17.037037037037038,0.06207173536669141
1219,11,2,0.18181818181818182,9,0,32354.3455544802,13.181818181818182,0.04873966347559811
1220,13,0,0.0,13,0,910.923956386882,16.153846153846153,0.07846172737813342
1221,16,0,0.0,16,0,9056.380766190934,9.0625,0.04918496936485649
1222,18,2,0.1111111111111111,16,0,0.05555555555555555,10.0,0.05179832543763701
1223,11,0,0.0,11,0,19279.13065706778,21.181818181818183,0.06245920637841875
1224,12,1,0.08333333333333333,11,0,348803.0925489994,12.416666666666666,0.05099118983672803
1225,3607,272,0.07540892708622124,3335,0,7948.105766685842,19.807596340449127,0.06537453759134026
1226,11,2,0.18181818181818182,9,0,157770.49029535666,14.363636363636363,0.06137926026443007
1227,11,2,0.18181818181818182,9,0,319641.12376974756,26.727272727272727,0.08515248530768858
1228,25,2,0.08,23,0,6548.031830850354,11.8,0.045414233773037986
1229,18,1,0.05555555555555555,17,0,15626.5,10.055555555555555,0.030726777738944215
1230,16,0,0.0,16,0,74594.265813019,17.3125,0.08373425048163641
1231,11,0,0.0,11,0,362227.66431900446,16.363636363636363,0.07354502893680123
1232,16,1,0.0625,15,0,168376.73534821562,21.75,0.05442142272590704
1233,13,1,0.07692307692307693,12,0,3632.7471678222137,10.0,0.04979143241653042
1234,11,1,0.09090909090909091,10,0,11.545454545454545,14.545454545454545,0.055758699188113006
1235,11,0,0.0,11,0,245223.83040119495,14.818181818181818,0.06711864465503442
1236,14,1,0.07142857142857142,13,0,2.380952380952381,10.642857142857142,0.05496191545942641
1237,13,0,0.0,13,0,0.0,5.769230769230769,0.04024717903803958
1238,12,0,0.0,12,0,0.0,6.916666666666667,0.041299924744397754
1239,11,1,0.09090909090909091,10,0,42372.84956759221,11.545454545454545,0.053495841996906816
1240,21,2,0.09523809523809523,19,0,142967.26438624965,22.238095238095237,0.07282586584273586
1241,5278,442,0.08374384236453201,4836,0,77973.83069910514,14.410003789314134,0.062071283509886346
