,total,LMICs,LMICs_perc,HICs,Unknown,Avg BC,Avg DC,Avg CC
0,2957,640,0.21643557659790327,2317,0,53608.592293829955,23.11227595536016,0.1312959611646318
1,14,2,0.14285714285714285,12,0,24172.96329379366,11.142857142857142,0.08769844207197315
2,28,7,0.25,21,0,180063.92876322774,38.67857142857143,0.14930571435553636
3,33,6,0.18181818181818182,27,0,137218.50490906372,28.454545454545453,0.1633697781720808
4,11,0,0.0,11,0,6764.617006912977,23.09090909090909,0.1473132180219965
5,105,19,0.18095238095238095,86,0,75532.37634236064,15.00952380952381,0.10666883868321687
6,30,9,0.3,21,0,51959.120172442126,31.266666666666666,0.14268406205625564
7,15,2,0.13333333333333333,13,0,10547.42992286094,19.4,0.12832270764581194
8,14,1,0.07142857142857142,13,0,501.4763484369969,15.214285714285714,0.067713310442375
9,23,4,0.17391304347826086,19,0,123587.69936341523,16.91304347826087,0.13562367037986384
10,12,2,0.16666666666666666,10,0,13361.636724978564,27.5,0.13063285415641024
11,23,5,0.21739130434782608,18,0,207420.491068864,26.17391304347826,0.15710306901363255
12,17,5,0.29411764705882354,12,0,2862.0642102170877,23.470588235294116,0.12964508381518094
13,14,1,0.07142857142857142,13,0,20203.635992200867,39.285714285714285,0.1463314510366791
14,28,3,0.10714285714285714,25,0,6144.720556117955,14.464285714285714,0.11054402444278874
15,20,4,0.2,16,0,7174.714786161503,12.7,0.11590339323168453
16,21,6,0.2857142857142857,15,0,122235.66546041096,20.952380952380953,0.13978199804903016
17,22,6,0.2727272727272727,16,0,49616.55155382585,22.318181818181817,0.12040359776059219
18,19,7,0.3684210526315789,12,0,47042.18399651051,18.94736842105263,0.1236998904616855
19,18,4,0.2222222222222222,14,0,1560.7990569884619,18.38888888888889,0.14053143846412494
20,28,5,0.17857142857142858,23,0,132098.85288662158,25.25,0.13881779714685175
21,13,6,0.46153846153846156,7,0,130.0738920152877,27.923076923076923,0.12831326087392753
22,17,5,0.29411764705882354,12,0,5952.350401734184,21.470588235294116,0.09777791403178604
23,13,3,0.23076923076923078,10,0,5683.327759188876,18.153846153846153,0.13105045667501244
24,29,6,0.20689655172413793,23,0,84923.70550385959,37.06896551724138,0.15872997140405706
25,20,3,0.15,17,0,14493.089185355193,16.0,0.11872845740849854
26,13,1,0.07692307692307693,12,0,152401.77854515112,26.53846153846154,0.12706341928281895
27,18,5,0.2777777777777778,13,0,145973.07875569334,39.44444444444444,0.15933858618596256
28,18,8,0.4444444444444444,10,0,46158.12382676793,16.88888888888889,0.12285464390498846
29,22,1,0.045454545454545456,21,0,23082.821430494987,26.90909090909091,0.13517615290744323
30,36,7,0.19444444444444445,29,0,31781.710954239716,17.11111111111111,0.12939269601488917
31,27,8,0.2962962962962963,19,0,69765.76886556607,18.925925925925927,0.10786616110806456
32,27,5,0.18518518518518517,22,0,76850.25526864956,43.48148148148148,0.138860839149551
33,17,7,0.4117647058823529,10,0,21895.603637467942,19.058823529411764,0.11705358366745797
34,13,1,0.07692307692307693,12,0,84098.66775087289,13.692307692307692,0.1280812983590015
35,50,11,0.22,39,0,174874.32331158203,52.24,0.14675338599838336
36,18,3,0.16666666666666666,15,0,18722.203887900938,24.22222222222222,0.14088465058253402
37,27,3,0.1111111111111111,24,0,45540.139804456856,26.14814814814815,0.1340634810215462
38,197,44,0.2233502538071066,153,0,0.0,14.918781725888325,0.14167301530713955
39,17,1,0.058823529411764705,16,0,130768.81560721876,17.823529411764707,0.1292242184364876
40,30,7,0.23333333333333334,23,0,15307.893176130812,20.466666666666665,0.13198863775251277
41,17,5,0.29411764705882354,12,0,9591.463740949139,16.58823529411765,0.10469917881180037
42,27,4,0.14814814814814814,23,0,45470.65392113538,30.62962962962963,0.15435226524915246
43,18,6,0.3333333333333333,12,0,140362.11543476032,42.55555555555556,0.15955909878163638
44,21,4,0.19047619047619047,17,0,32771.380020432225,25.19047619047619,0.13068716524021126
45,33,5,0.15151515151515152,28,0,30662.977679239968,20.96969696969697,0.11383192768502391
46,25,5,0.2,20,0,8304.353760952195,24.4,0.1456467273066369
47,17,3,0.17647058823529413,14,0,28371.986523356063,28.41176470588235,0.15359718948162518
48,15,2,0.13333333333333333,13,0,25630.198106749485,31.8,0.12963439773117835
49,23,5,0.21739130434782608,18,0,202445.19300408353,28.47826086956522,0.14692379079312898
50,14,3,0.21428571428571427,11,0,13882.652171842408,17.714285714285715,0.1331563812015051
51,23,6,0.2608695652173913,17,0,19030.427313873726,33.65217391304348,0.14028319810781828
52,22,4,0.18181818181818182,18,0,176178.00143033633,26.318181818181817,0.12617570590112273
53,19,2,0.10526315789473684,17,0,21739.146809576127,17.0,0.11514646943364633
54,17,2,0.11764705882352941,15,0,69095.14449656112,26.235294117647058,0.11575578195826906
55,14,5,0.35714285714285715,9,0,0.0,19.571428571428573,0.10020877745665543
56,27,4,0.14814814814814814,23,0,65487.912462116095,29.88888888888889,0.13477237989579252
57,20,2,0.1,18,0,60556.210874016244,30.75,0.11769985187534451
58,26,6,0.23076923076923078,20,0,1193.3113528124627,23.53846153846154,0.14605827138724922
59,59,16,0.2711864406779661,43,0,260982.32917288123,18.796610169491526,0.10188528014974767
60,19,3,0.15789473684210525,16,0,62.81842667678723,12.68421052631579,0.10147562226187451
61,18,4,0.2222222222222222,14,0,4296.1798230985305,27.38888888888889,0.14869680888308867
62,11,2,0.18181818181818182,9,0,0.0,19.09090909090909,0.11668964361289234
63,24,6,0.25,18,0,113619.61863483202,38.25,0.15685927838452698
64,22,4,0.18181818181818182,18,0,135330.9783564073,20.90909090909091,0.13441405363196798
65,22,4,0.18181818181818182,18,0,33820.14240710533,24.5,0.12891760079820547
66,13,3,0.23076923076923078,10,0,26270.367332201502,31.846153846153847,0.12533013860737693
67,14,2,0.14285714285714285,12,0,91686.2048110389,34.42857142857143,0.15269884633998113
68,21,4,0.19047619047619047,17,0,204734.24892960058,35.904761904761905,0.14405575423171657
69,18,5,0.2777777777777778,13,0,47973.97568521928,28.444444444444443,0.13838839345022194
70,23,7,0.30434782608695654,16,0,41749.751282277764,24.695652173913043,0.14005630484716608
71,17,5,0.29411764705882354,12,0,8124.043730443231,15.941176470588236,0.13703135166780647
72,41,8,0.1951219512195122,33,0,484545.54645880655,36.53658536585366,0.14724987747192617
73,17,4,0.23529411764705882,13,0,42257.832531002874,25.11764705882353,0.11440340019599488
74,13,1,0.07692307692307693,12,0,38244.388776527965,12.923076923076923,0.09192570137602804
75,11,3,0.2727272727272727,8,0,31637.256029297714,25.454545454545453,0.15497978183523825
76,14,1,0.07142857142857142,13,0,0.0,28.785714285714285,0.14816757250365123
77,48,9,0.1875,39,0,226149.5357136488,18.083333333333332,0.10484206474194285
78,25,6,0.24,19,0,132108.24315892803,25.68,0.15059311948708795
79,24,5,0.20833333333333334,19,0,21051.741460228033,20.5,0.14877098387193946
80,30,7,0.23333333333333334,23,0,94610.58592054028,28.333333333333332,0.14067311910131364
81,26,10,0.38461538461538464,16,0,103820.32581384628,33.11538461538461,0.11922869805157087
82,25,6,0.24,19,0,12528.496644122752,15.96,0.124247894862037
83,68,13,0.19117647058823528,55,0,83278.24578342008,17.426470588235293,0.09443713064572097
84,17,6,0.35294117647058826,11,0,7220.456098312888,13.823529411764707,0.11894399371067459
85,18,3,0.16666666666666666,15,0,19853.829497469378,14.88888888888889,0.1157928046277771
86,20,2,0.1,18,0,53833.497467686815,31.95,0.1475027139002566
87,26,4,0.15384615384615385,22,0,36796.5244056112,29.53846153846154,0.1600619245802308
88,23,5,0.21739130434782608,18,0,34017.29020668871,42.69565217391305,0.15716282596237424
89,36,12,0.3333333333333333,24,0,211926.7476696463,22.61111111111111,0.08768788649414988
90,28,8,0.2857142857142857,20,0,24667.313338901648,29.142857142857142,0.13694441605759464
91,30,4,0.13333333333333333,26,0,16428.49802859401,18.333333333333332,0.10297595612840145
92,18,2,0.1111111111111111,16,0,51730.638002167805,17.77777777777778,0.11688942888277348
93,14,3,0.21428571428571427,11,0,127129.02427678113,21.428571428571427,0.13178479996829312
94,28,7,0.25,21,0,27952.7344826986,15.964285714285714,0.11174894478172567
95,34,6,0.17647058823529413,28,0,8686.947524333586,16.058823529411764,0.12506331053165795
96,13,3,0.23076923076923078,10,0,0.0,18.307692307692307,0.09131219057601617
97,21,2,0.09523809523809523,19,0,9213.209867485863,12.571428571428571,0.12026226656933711
98,24,4,0.16666666666666666,20,0,20509.951832666808,19.708333333333332,0.16385260780079297
99,16,5,0.3125,11,0,6552.014291504281,9.8125,0.11024392116103245
100,20,3,0.15,17,0,28823.39596858503,14.6,0.10837881273804575
101,20,3,0.15,17,0,83350.39061036421,41.3,0.13633010121295014
102,39,9,0.23076923076923078,30,0,25063.679685165545,34.61538461538461,0.16214440145998316
103,14,1,0.07142857142857142,13,0,7896.934481155833,18.0,0.11946714916209947
104,17,2,0.11764705882352941,15,0,13299.83963588353,23.352941176470587,0.14979194872371726
105,20,3,0.15,17,0,39796.426756940346,40.2,0.1317112092601129
106,20,4,0.2,16,0,91706.10340056359,25.7,0.14382497987146411
107,21,2,0.09523809523809523,19,0,31965.692775723885,26.333333333333332,0.1318154963522438
108,24,2,0.08333333333333333,22,0,35836.373079013916,14.125,0.13879260703700505
109,18,7,0.3888888888888889,11,0,3947.9035594463066,17.11111111111111,0.1235697832962876
110,44,9,0.20454545454545456,35,0,238470.8206389487,23.954545454545453,0.12040740932972326
111,12,2,0.16666666666666666,10,0,63344.47470757056,18.5,0.12046271547884152
112,21,5,0.23809523809523808,16,0,123992.1523634004,38.61904761904762,0.15405994756518265
113,45,5,0.1111111111111111,40,0,109988.72093943825,24.377777777777776,0.14314522153531203
114,27,5,0.18518518518518517,22,0,48248.65193430292,25.51851851851852,0.13658177157829993
115,12,3,0.25,9,0,190.7751984536233,21.666666666666668,0.13141660600117583
116,60,12,0.2,48,0,126581.14320359145,23.116666666666667,0.12358464357506789
117,11,2,0.18181818181818182,9,0,44240.0,17.636363636363637,0.12152655857949272
118,14,2,0.14285714285714285,12,0,159.89646264057166,13.285714285714286,0.14161241348487166
119,46,13,0.2826086956521739,33,0,126508.94849049253,26.847826086956523,0.16039866191715166
120,23,4,0.17391304347826086,19,0,27272.825898949275,18.73913043478261,0.11559991161566267
121,16,2,0.125,14,0,1789.2228130641145,12.6875,0.13413435304963092
122,17,2,0.11764705882352941,15,0,4475.292283389609,22.88235294117647,0.13795454882909527
123,16,3,0.1875,13,0,1930.888888889269,24.6875,0.1334718191225208
124,28,4,0.14285714285714285,24,0,21639.870244496044,18.321428571428573,0.11263129166895698
125,30,4,0.13333333333333333,26,0,330266.94222084206,23.666666666666668,0.1052344499883017
126,21,3,0.14285714285714285,18,0,0.0,14.142857142857142,0.10711002528981532
127,17,2,0.11764705882352941,15,0,259538.63416190888,19.88235294117647,0.1408539567432773
128,20,3,0.15,17,0,275969.7396084318,22.35,0.13348664192711085
129,20,2,0.1,18,0,14592.231715418267,21.1,0.13668287169155688
130,11,3,0.2727272727272727,8,0,188824.77748217952,22.727272727272727,0.10788113790710908
131,26,8,0.3076923076923077,18,0,28354.047410209747,16.46153846153846,0.11778397590219601
132,19,3,0.15789473684210525,16,0,7096.800017031835,34.8421052631579,0.14198398511869476
133,12,3,0.25,9,0,13102.375888732859,21.25,0.1370547694689068
134,20,1,0.05,19,0,4213.743905071603,19.8,0.10133393322381931
135,26,8,0.3076923076923077,18,0,434.14946522732924,13.807692307692308,0.12963882491479994
136,13,1,0.07692307692307693,12,0,26306.501265246425,34.84615384615385,0.15476773885507045
137,17,6,0.35294117647058826,11,0,22929.08686415485,36.64705882352941,0.1292674863739491
138,27,4,0.14814814814814814,23,0,8657.734502739375,15.814814814814815,0.13173232740169707
139,23,4,0.17391304347826086,19,0,52295.37280096377,25.17391304347826,0.15359235626386344
140,20,3,0.15,17,0,55034.02318560984,21.25,0.12930332969505565
141,22,5,0.22727272727272727,17,0,0.0,10.727272727272727,0.10902986340785281
142,15,6,0.4,9,0,8949.766260619945,14.6,0.10808889851110415
143,24,5,0.20833333333333334,19,0,3631.812193820558,18.041666666666668,0.1376442205577543
144,31,6,0.1935483870967742,25,0,66954.51509894045,21.29032258064516,0.12384590856056421
145,29,7,0.2413793103448276,22,0,24190.38029686886,15.793103448275861,0.11763750798256463
146,63,12,0.19047619047619047,51,0,111470.9126053665,19.841269841269842,0.14451403223183754
147,19,2,0.10526315789473684,17,0,13251.551835332015,34.31578947368421,0.14966857482212817
148,24,4,0.16666666666666666,20,0,966.4111111115554,14.875,0.12199308082359088
149,14,2,0.14285714285714285,12,0,5021.513148156317,13.571428571428571,0.09004884851828754
150,27,4,0.14814814814814814,23,0,64860.01264430267,28.59259259259259,0.12755561156202677
151,16,4,0.25,12,0,12864.844039981212,29.0,0.09656779101220839
152,18,2,0.1111111111111111,16,0,41792.81003641112,35.05555555555556,0.15286863324178068
153,18,4,0.2222222222222222,14,0,50878.21163807971,33.111111111111114,0.1314690815942899
154,16,2,0.125,14,0,18894.916779541272,31.0625,0.12266535756437252
155,36,3,0.08333333333333333,33,0,9916.905594126765,26.27777777777778,0.14500587379849864
156,20,4,0.2,16,0,5366.290086026298,31.4,0.14087962112148283
157,20,4,0.2,16,0,44661.56933864668,16.2,0.11922885299508948
158,22,9,0.4090909090909091,13,0,10979.205230417901,23.5,0.12605851301464993
159,17,3,0.17647058823529413,14,0,27941.711971468416,20.352941176470587,0.11279552992531316
160,25,6,0.24,19,0,32328.41810870141,14.88,0.14279835439967856
161,33,7,0.21212121212121213,26,0,24966.40888788401,23.727272727272727,0.15306778245377872
162,16,2,0.125,14,0,6279.019655236756,20.4375,0.13963196105191675
163,19,5,0.2631578947368421,14,0,148132.53033706543,21.31578947368421,0.12722300716416599
164,20,5,0.25,15,0,20176.899729367702,19.4,0.15146217591911978
165,17,1,0.058823529411764705,16,0,10899.06618165094,27.176470588235293,0.1354303532750609
166,35,4,0.11428571428571428,31,0,14581.963606687512,21.82857142857143,0.12412225882158344
167,44,12,0.2727272727272727,32,0,184372.9606196921,28.681818181818183,0.134150037827796
168,18,2,0.1111111111111111,16,0,34731.505565072184,16.833333333333332,0.13345144616633983
169,19,5,0.2631578947368421,14,0,175117.5811970334,32.78947368421053,0.14298767540484433
170,11,0,0.0,11,0,5111.468958952565,18.545454545454547,0.1361885949282412
171,14,2,0.14285714285714285,12,0,24974.411268283227,12.571428571428571,0.10972897864543775
172,12,1,0.08333333333333333,11,0,37122.64391940894,30.666666666666668,0.1672495851523116
173,15,2,0.13333333333333333,13,0,2909.635417005055,13.6,0.11637922714229387
174,17,0,0.0,17,0,12189.083217096813,20.58823529411765,0.13052152618817822
175,22,0,0.0,22,0,150451.16932572756,25.045454545454547,0.14812366329476792
176,24,3,0.125,21,0,64778.25949625749,24.875,0.11164189056271549
177,19,9,0.47368421052631576,10,0,31597.008005983786,21.05263157894737,0.12076676331542066
178,22,2,0.09090909090909091,20,0,82804.79198235288,42.27272727272727,0.1408344326365208
179,21,5,0.23809523809523808,16,0,423.52454757943417,15.666666666666666,0.08187129299399437
180,22,2,0.09090909090909091,20,0,327282.53441087203,33.22727272727273,0.14673105035320166
181,21,2,0.09523809523809523,19,0,1031.7043836329326,15.333333333333334,0.12811342641585463
182,12,1,0.08333333333333333,11,0,25402.06164778062,24.0,0.10297382025457817
183,13,3,0.23076923076923078,10,0,4062.398838149888,17.76923076923077,0.12388563294531589
184,15,5,0.3333333333333333,10,0,149941.47554436626,34.6,0.14799567365618063
185,16,1,0.0625,15,0,78798.42669372246,24.875,0.13508356849865744
186,20,8,0.4,12,0,14051.09198101497,22.4,0.12982859477465114
187,47,12,0.2553191489361702,35,0,67555.60115602451,21.382978723404257,0.13715135192555397
188,15,1,0.06666666666666667,14,0,36989.41362488213,53.13333333333333,0.17736350178547014
189,19,4,0.21052631578947367,15,0,196509.31646940546,17.894736842105264,0.13058120177701596
190,16,2,0.125,14,0,12655.44744607988,18.0,0.1474255305237223
191,25,2,0.08,23,0,217786.80168080275,42.68,0.14196155410489014
192,17,3,0.17647058823529413,14,0,398994.54671399825,31.823529411764707,0.15483409679597457
193,38,11,0.2894736842105263,27,0,10059.648603772162,21.31578947368421,0.13373881647221386
194,25,4,0.16,21,0,11226.558965798133,14.84,0.12848492566048353
195,22,3,0.13636363636363635,19,0,34.7210058112941,11.454545454545455,0.13424622947128692
196,25,9,0.36,16,0,5434.9115383872595,26.0,0.12126208524516156
197,44,3,0.06818181818181818,41,0,18044.793244657867,9.818181818181818,0.09655765721854022
198,20,4,0.2,16,0,237889.4103479269,30.5,0.152016221627582
199,32,3,0.09375,29,0,16098.666865190738,14.875,0.11215111214454715
200,27,5,0.18518518518518517,22,0,131861.71991745135,29.74074074074074,0.12958674623995606
201,12,3,0.25,9,0,6.944444444444444,16.416666666666668,0.13297195919918656
202,20,2,0.1,18,0,4485.410173816279,15.05,0.11237187783407028
203,24,7,0.2916666666666667,17,0,15572.882258162152,18.083333333333332,0.12088324170600195
204,14,1,0.07142857142857142,13,0,313481.71446275956,23.857142857142858,0.1281055031203895
205,13,1,0.07692307692307693,12,0,47018.18598784651,20.923076923076923,0.11142657616383272
206,16,4,0.25,12,0,70524.65718604122,37.0,0.16015865210975957
207,17,2,0.11764705882352941,15,0,582.9094193395223,23.705882352941178,0.13101653644478867
208,19,4,0.21052631578947367,15,0,0.0,17.105263157894736,0.10979680181617361
209,18,3,0.16666666666666666,15,0,232485.26345002613,26.333333333333332,0.11272869472165215
210,25,10,0.4,15,0,14807.200182713632,16.2,0.1277585330804379
211,14,2,0.14285714285714285,12,0,134406.78020530994,25.571428571428573,0.13907035963482992
212,15,1,0.06666666666666667,14,0,14305.74920420476,37.266666666666666,0.10125538723394832
213,46,10,0.21739130434782608,36,0,12346.236418375616,21.130434782608695,0.12871470499253643
214,14,3,0.21428571428571427,11,0,20596.173751927483,20.571428571428573,0.13387454771692509
215,17,2,0.11764705882352941,15,0,29103.721109132843,17.0,0.11023265248112876
216,12,2,0.16666666666666666,10,0,17893.8825994727,14.416666666666666,0.11884139798980638
217,20,4,0.2,16,0,13698.447043339396,28.25,0.1438008038029776
218,14,5,0.35714285714285715,9,0,20966.855284346082,41.357142857142854,0.15800504504145693
219,29,3,0.10344827586206896,26,0,17226.1872637547,18.517241379310345,0.1279224854470513
220,14,3,0.21428571428571427,11,0,91010.86728399608,23.285714285714285,0.13557780121412558
221,29,7,0.2413793103448276,22,0,55688.60293563011,22.03448275862069,0.14023409510656634
222,23,1,0.043478260869565216,22,0,86496.6498596095,20.82608695652174,0.14910641509911707
223,13,3,0.23076923076923078,10,0,41.888621710320685,18.076923076923077,0.06919808802500024
224,23,6,0.2608695652173913,17,0,160831.13841617625,22.956521739130434,0.15035525139119052
225,12,1,0.08333333333333333,11,0,0.0,11.916666666666666,0.11400721484092542
226,35,5,0.14285714285714285,30,0,78524.45419813886,31.114285714285714,0.12976725051378976
227,18,3,0.16666666666666666,15,0,28769.928877120645,32.111111111111114,0.14197544379286098
228,27,10,0.37037037037037035,17,0,37669.787593815425,17.62962962962963,0.14156840294031225
229,27,5,0.18518518518518517,22,0,11625.577604340626,22.037037037037038,0.11172581343011125
230,27,5,0.18518518518518517,22,0,123443.52742464577,26.14814814814815,0.1651583176543978
231,13,2,0.15384615384615385,11,0,23978.932775752623,16.0,0.1318830048341308
232,95,19,0.2,76,0,361189.6386144615,22.11578947368421,0.10724943391537961
233,19,5,0.2631578947368421,14,0,41634.07878047152,17.31578947368421,0.11854973909102763
234,22,4,0.18181818181818182,18,0,166727.20973530904,22.09090909090909,0.11325153896226077
235,12,3,0.25,9,0,377.0164949734039,20.5,0.1273143111167332
236,26,5,0.19230769230769232,21,0,17235.358522417355,16.653846153846153,0.13141598638486027
237,31,5,0.16129032258064516,26,0,143462.2103195623,57.41935483870968,0.16598266693600616
238,11,4,0.36363636363636365,7,0,33780.04356294992,11.727272727272727,0.1011372828018794
239,35,5,0.14285714285714285,30,0,2794.2604354345117,16.2,0.14439445615311142
240,13,4,0.3076923076923077,9,0,160372.17533200636,23.0,0.16790769919945242
241,12,1,0.08333333333333333,11,0,0.0,17.25,0.128675705712167
242,30,2,0.06666666666666667,28,0,3611.359292800534,15.1,0.11922559866531895
243,32,5,0.15625,27,0,43461.18379629022,19.25,0.1154497925228043
244,25,3,0.12,22,0,30067.000605604262,24.52,0.1265712960773453
245,40,8,0.2,32,0,32895.27779708021,13.2,0.11697196780964969
246,25,5,0.2,20,0,5391.521636779242,13.52,0.11887638256597938
247,102,9,0.08823529411764706,93,0,151523.73279049396,19.725490196078432,0.13025587650642464
248,16,0,0.0,16,0,22498.779454327992,20.8125,0.13726648148590548
249,20,3,0.15,17,0,896.9196980223267,12.1,0.10798284103670305
250,19,3,0.15789473684210525,16,0,51168.13079876229,15.842105263157896,0.15071019428418966
251,32,9,0.28125,23,0,55868.29908944451,15.8125,0.08893187166888332
252,16,2,0.125,14,0,11996.239201785706,28.375,0.1287468419233945
253,11,0,0.0,11,0,8670.132530545061,18.09090909090909,0.12173161503420432
254,12,2,0.16666666666666666,10,0,29398.89468323984,17.333333333333332,0.10470196385988358
255,20,6,0.3,14,0,13115.650616609191,22.75,0.14153256480784548
256,29,4,0.13793103448275862,25,0,13288.862211997304,15.275862068965518,0.11497103200204202
257,45,10,0.2222222222222222,35,0,26376.58518156605,14.6,0.08446316695490068
258,12,1,0.08333333333333333,11,0,24271.708275392633,32.583333333333336,0.14344927603827684
259,16,4,0.25,12,0,13355.520243534367,22.375,0.14849221969387688
260,21,4,0.19047619047619047,17,0,12226.915225114868,19.571428571428573,0.12041842710576998
261,14,6,0.42857142857142855,8,0,79482.12741798721,28.071428571428573,0.1344152699128221
262,34,10,0.29411764705882354,24,0,61539.62276237099,25.264705882352942,0.14758669966340227
263,16,3,0.1875,13,0,232634.73809570566,27.75,0.15150101738002122
264,22,1,0.045454545454545456,21,0,45132.09622479039,28.227272727272727,0.15117827859712693
265,23,5,0.21739130434782608,18,0,1946.4786928954566,15.91304347826087,0.11339498807397712
266,19,6,0.3157894736842105,13,0,5430.306345171918,13.631578947368421,0.13986473653385817
267,30,4,0.13333333333333333,26,0,10858.703090623942,29.166666666666668,0.11709547881717919
268,17,4,0.23529411764705882,13,0,2571.4996561318285,30.941176470588236,0.15783345363397522
269,14,3,0.21428571428571427,11,0,37829.26795329483,15.928571428571429,0.13476547105114073
270,11,4,0.36363636363636365,7,0,48044.39959511447,19.09090909090909,0.09765833448143128
271,11,2,0.18181818181818182,9,0,109695.5771691851,19.454545454545453,0.1678733014560116
272,80,14,0.175,66,0,228657.41045892617,28.5,0.13324066181666022
273,15,3,0.2,12,0,0.0,27.0,0.14888386914612456
274,22,6,0.2727272727272727,16,0,38984.5034368986,25.772727272727273,0.13103297418078833
275,13,2,0.15384615384615385,11,0,10154.823675411639,22.384615384615383,0.1546605727119492
276,12,3,0.25,9,0,9487.729621969715,41.416666666666664,0.11701534393196013
277,17,6,0.35294117647058826,11,0,131546.37423986124,28.647058823529413,0.14081930626104486
278,11,5,0.45454545454545453,6,0,15808.181818181822,18.09090909090909,0.10784777161653647
279,18,7,0.3888888888888889,11,0,57352.32082587298,16.166666666666668,0.12449025496423942
280,13,3,0.23076923076923078,10,0,137153.18940503852,66.23076923076923,0.157758861455552
281,37,3,0.08108108108108109,34,0,159058.83979378306,27.54054054054054,0.12166446145702844
282,26,8,0.3076923076923077,18,0,5640.312331360092,14.692307692307692,0.1288711396155383
283,13,2,0.15384615384615385,11,0,13.846153846153847,24.076923076923077,0.1055034507373681
284,13,2,0.15384615384615385,11,0,6657.716929956319,13.384615384615385,0.12523689531639487
285,13,2,0.15384615384615385,11,0,4124.5604805913135,21.46153846153846,0.13664409736890598
286,15,4,0.26666666666666666,11,0,31065.115359540578,18.933333333333334,0.11101300186756605
287,26,5,0.19230769230769232,21,0,60026.799242743975,19.576923076923077,0.11248333891914315
288,26,6,0.23076923076923078,20,0,47130.51528434929,39.96153846153846,0.15634376391576793
289,26,7,0.2692307692307692,19,0,8836.576533818532,15.5,0.1295611548958958
290,15,2,0.13333333333333333,13,0,127883.69666732178,31.266666666666666,0.16825272911512573
291,18,3,0.16666666666666666,15,0,16487.61636633772,34.22222222222222,0.1259929410029193
292,22,4,0.18181818181818182,18,0,1.5272727272727273,13.454545454545455,0.1111924845078073
293,32,6,0.1875,26,0,16260.225244148334,16.78125,0.1258011513394622
294,15,2,0.13333333333333333,13,0,64804.118608883575,48.0,0.11982474382888084
295,22,3,0.13636363636363635,19,0,0.0,12.681818181818182,0.09291139901904887
296,33,11,0.3333333333333333,22,0,196653.29707247482,45.57575757575758,0.16033033669699673
297,17,4,0.23529411764705882,13,0,10953.38494842797,18.41176470588235,0.1364232983100734
298,18,6,0.3333333333333333,12,0,263522.3801867378,43.388888888888886,0.16297263045551888
299,13,2,0.15384615384615385,11,0,34506.10105459102,26.153846153846153,0.1519414905598175
300,18,3,0.16666666666666666,15,0,11542.877285070515,16.555555555555557,0.11583369730771947
301,45,8,0.17777777777777778,37,0,71761.52420613483,21.533333333333335,0.1264929239980215
302,11,2,0.18181818181818182,9,0,39484.0713314587,18.363636363636363,0.09535587782355243
303,35,10,0.2857142857142857,25,0,42086.30678298535,29.02857142857143,0.138325182867034
304,24,2,0.08333333333333333,22,0,25052.924818580068,18.333333333333332,0.1147072391098881
305,13,1,0.07692307692307693,12,0,5350.461538461538,13.076923076923077,0.10671005801449653
306,21,6,0.2857142857142857,15,0,49239.59056264664,31.523809523809526,0.13200469686920083
307,15,3,0.2,12,0,31928.515071572376,25.066666666666666,0.12671740850375204
308,19,4,0.21052631578947367,15,0,43674.87654919067,23.789473684210527,0.1548113568051904
309,28,3,0.10714285714285714,25,0,111782.33643575375,37.07142857142857,0.1573449281798651
310,19,6,0.3157894736842105,13,0,6521.368880036135,35.421052631578945,0.12659497474715625
311,14,1,0.07142857142857142,13,0,94423.57411364667,38.42857142857143,0.12066364181769788
312,13,3,0.23076923076923078,10,0,5055.297563025043,30.846153846153847,0.14825521511853185
313,50,11,0.22,39,0,109322.72361919197,20.52,0.12258436839336798
314,15,2,0.13333333333333333,13,0,42417.35087049764,15.266666666666667,0.11938602156508567
315,14,3,0.21428571428571427,11,0,933.6348949366266,11.214285714285714,0.10220810782518037
316,33,3,0.09090909090909091,30,0,2073.694188173913,22.242424242424242,0.11890349450793711
317,12,5,0.4166666666666667,7,0,15233.410052603676,12.5,0.1111611029022775
318,32,8,0.25,24,0,9208.561848757006,23.8125,0.11769964641225833
319,33,5,0.15151515151515152,28,0,45763.45151492748,22.87878787878788,0.1272602568245557
320,34,8,0.23529411764705882,26,0,191400.20682284198,28.058823529411764,0.12991177268744078
321,13,2,0.15384615384615385,11,0,124925.73237162137,24.923076923076923,0.12662469511742244
322,13,4,0.3076923076923077,9,0,46681.62432525835,19.76923076923077,0.1493547958021184
323,15,1,0.06666666666666667,14,0,23226.838145919726,34.13333333333333,0.1272852607772946
324,25,3,0.12,22,0,8037.611466706048,12.72,0.12263627105013536
325,27,3,0.1111111111111111,24,0,109529.8835302315,23.925925925925927,0.15344144315219146
326,16,6,0.375,10,0,5749.758146678374,14.5,0.14109402985460567
327,13,1,0.07692307692307693,12,0,74178.51252849032,47.76923076923077,0.1635200176638144
328,12,1,0.08333333333333333,11,0,0.027777777777777776,32.333333333333336,0.07507314624420454
329,16,2,0.125,14,0,7110.715437293362,19.0625,0.10838880327406644
330,12,1,0.08333333333333333,11,0,0.0,25.75,0.10559626918665987
331,44,5,0.11363636363636363,39,0,36674.9845739088,16.25,0.13518628422577006
332,37,6,0.16216216216216217,31,0,9050.39679577747,18.81081081081081,0.12630384424345117
333,13,6,0.46153846153846156,7,0,52274.35800588072,30.0,0.13246660709926408
334,15,3,0.2,12,0,48729.22512611478,23.066666666666666,0.1409953675851199
335,16,1,0.0625,15,0,4497.080479726727,26.1875,0.1297885781729869
336,23,3,0.13043478260869565,20,0,86301.89761037086,26.0,0.15886566020506354
337,50,8,0.16,42,0,7713.946219962835,15.88,0.1223804213071894
338,14,4,0.2857142857142857,10,0,69012.4533459176,12.928571428571429,0.11391813695034171
339,31,3,0.0967741935483871,28,0,79353.54454351013,16.129032258064516,0.10906271676761913
340,13,3,0.23076923076923078,10,0,18240.728990807816,14.692307692307692,0.12045165367012826
341,13,5,0.38461538461538464,8,0,7383.739333229852,32.38461538461539,0.15299034644389484
342,18,5,0.2777777777777778,13,0,0.2962962962962962,14.277777777777779,0.11530811264197352
343,12,5,0.4166666666666667,7,0,19455.247713059118,18.166666666666668,0.1283697893806651
344,11,6,0.5454545454545454,5,0,16934.213513294664,21.363636363636363,0.12946791373867614
345,13,2,0.15384615384615385,11,0,257796.3447007965,39.23076923076923,0.16654560223007236
346,15,1,0.06666666666666667,14,0,22731.40281923692,21.0,0.1255250884596286
347,36,4,0.1111111111111111,32,0,6225.205066506674,19.5,0.13568473085458965
348,32,3,0.09375,29,0,31830.65678133665,28.03125,0.14795828686769164
349,20,2,0.1,18,0,5242.5444059879765,17.4,0.10990072591615563
350,11,0,0.0,11,0,126250.74511035647,33.81818181818182,0.1218670207158221
351,25,4,0.16,21,0,893.0872229704067,18.84,0.1360966278861989
352,11,2,0.18181818181818182,9,0,0.0,13.090909090909092,0.10788957161549054
353,13,4,0.3076923076923077,9,0,34306.728452696065,26.692307692307693,0.13862290688746823
354,13,0,0.0,13,0,2674.1282051282033,22.0,0.12391571150181731
355,21,4,0.19047619047619047,17,0,110105.76224333083,42.857142857142854,0.1526282405196063
356,26,6,0.23076923076923078,20,0,37404.27590802431,18.846153846153847,0.10073005903234303
357,38,7,0.18421052631578946,31,0,80912.89707273307,24.289473684210527,0.1328084467438239
358,44,6,0.13636363636363635,38,0,1000.9818973212183,16.09090909090909,0.11499534385708295
359,15,4,0.26666666666666666,11,0,5382.567342524843,16.666666666666668,0.12157405872063155
360,30,7,0.23333333333333334,23,0,134043.53453191274,20.233333333333334,0.09762158221110723
361,26,6,0.23076923076923078,20,0,230959.82970642435,24.846153846153847,0.09122011397477171
362,17,4,0.23529411764705882,13,0,63889.602105638696,23.941176470588236,0.14732843667891102
363,14,2,0.14285714285714285,12,0,6500.922054394437,37.785714285714285,0.11829809493687181
364,11,3,0.2727272727272727,8,0,4224.595782651561,15.545454545454545,0.12064705609897525
365,37,12,0.32432432432432434,25,0,75456.84997983571,17.2972972972973,0.11036129710247189
366,12,3,0.25,9,0,18649.76238790948,14.083333333333334,0.12969185290052965
367,17,4,0.23529411764705882,13,0,12354.482291124466,11.647058823529411,0.0863272401084648
368,39,6,0.15384615384615385,33,0,31654.281126248457,18.05128205128205,0.13135883518458896
369,18,4,0.2222222222222222,14,0,116661.11252440698,27.944444444444443,0.15583941900372997
370,15,3,0.2,12,0,682.3495817635885,13.533333333333333,0.12020580351761442
371,18,5,0.2777777777777778,13,0,18898.505195833022,21.22222222222222,0.11446633676543401
372,15,4,0.26666666666666666,11,0,53.636126892648754,15.666666666666666,0.1198736313748907
373,19,1,0.05263157894736842,18,0,33039.21441089204,13.947368421052632,0.10113585222947585
374,20,6,0.3,14,0,0.0,10.55,0.13227921922510535
375,13,1,0.07692307692307693,12,0,5767.008752765322,17.076923076923077,0.14351183476325702
376,38,5,0.13157894736842105,33,0,139517.99795659608,29.5,0.12577530668594458
377,11,3,0.2727272727272727,8,0,36524.49708488724,22.181818181818183,0.11624513694847406
378,12,1,0.08333333333333333,11,0,6405.304687393723,19.166666666666668,0.1447009126759504
379,15,2,0.13333333333333333,13,0,6137.622269866767,14.066666666666666,0.12750162308561627
380,13,3,0.23076923076923078,10,0,21004.546302973766,28.53846153846154,0.11010788806593372
381,21,2,0.09523809523809523,19,0,9229.569270590446,20.714285714285715,0.1285113617102461
382,21,5,0.23809523809523808,16,0,0.0,23.428571428571427,0.12267636155101067
383,59,12,0.2033898305084746,47,0,9915.216244224459,16.728813559322035,0.13693449897631302
384,14,5,0.35714285714285715,9,0,7228.636373442999,31.857142857142858,0.12463093930399478
385,24,4,0.16666666666666666,20,0,80431.15483472955,23.041666666666668,0.12630163466443745
386,11,1,0.09090909090909091,10,0,0.0,17.727272727272727,0.11422251113087957
387,11,1,0.09090909090909091,10,0,53699.223528945964,33.0,0.1276598444796884
388,19,3,0.15789473684210525,16,0,168890.33279107703,44.68421052631579,0.16374247327830715
389,12,1,0.08333333333333333,11,0,0.0,21.916666666666668,0.11958956505538847
390,14,4,0.2857142857142857,10,0,68027.63122359208,31.642857142857142,0.14535382100347674
391,15,6,0.4,9,0,2.8035675524402186,20.933333333333334,0.12400335015337191
392,24,3,0.125,21,0,54567.89422442322,16.416666666666668,0.11027460427205722
393,11,4,0.36363636363636365,7,0,0.0,21.454545454545453,0.12943417814931044
394,26,7,0.2692307692307692,19,0,10107.334606990216,18.653846153846153,0.13410390120748253
395,12,2,0.16666666666666666,10,0,6759.777816159375,24.416666666666668,0.1145634374673198
396,32,6,0.1875,26,0,128432.72303263939,15.34375,0.10269365436248448
397,11,2,0.18181818181818182,9,0,4661.918254266664,19.727272727272727,0.11223240734113617
398,23,12,0.5217391304347826,11,0,3346.945421179541,22.869565217391305,0.12650664689923163
399,35,8,0.22857142857142856,27,0,64561.942995612175,25.4,0.13739808810027979
400,13,2,0.15384615384615385,11,0,151263.77221028676,33.38461538461539,0.13761972592461952
401,38,7,0.18421052631578946,31,0,59257.38681008072,34.71052631578947,0.14743044105019673
402,18,1,0.05555555555555555,17,0,82317.06798180481,27.444444444444443,0.1471521180741704
403,15,3,0.2,12,0,5055.920317914878,19.933333333333334,0.09450411078596574
404,15,4,0.26666666666666666,11,0,41266.42038281864,18.2,0.13421801549110438
405,13,1,0.07692307692307693,12,0,51.02909313327917,16.923076923076923,0.1110242231456679
406,12,0,0.0,12,0,25398.032951058,27.083333333333332,0.13654078075602663
407,12,4,0.3333333333333333,8,0,6394.16337119045,18.083333333333332,0.12106835968525177
408,28,6,0.21428571428571427,22,0,10141.591747269495,19.214285714285715,0.13792956545477916
409,24,7,0.2916666666666667,17,0,34907.78680299968,18.166666666666668,0.13461732013557504
410,19,4,0.21052631578947367,15,0,1342.6184395722973,17.57894736842105,0.12013734094991095
411,12,0,0.0,12,0,9317.48299925975,29.916666666666668,0.09732092431907358
412,13,1,0.07692307692307693,12,0,45901.48874426473,41.0,0.1442603291130806
413,19,2,0.10526315789473684,17,0,251395.8980082889,25.05263157894737,0.15595950476663614
414,17,4,0.23529411764705882,13,0,7486.912754135841,31.941176470588236,0.1279880441354901
415,15,4,0.26666666666666666,11,0,67389.27638220112,19.066666666666666,0.13401470490107184
416,14,1,0.07142857142857142,13,0,41348.98032843423,31.357142857142858,0.14528465534983018
417,18,6,0.3333333333333333,12,0,6794.057529845728,14.333333333333334,0.12724994857244049
418,13,5,0.38461538461538464,8,0,0.0,17.46153846153846,0.1217949880648542
419,29,6,0.20689655172413793,23,0,116886.11035303294,23.17241379310345,0.1469965372942212
420,15,1,0.06666666666666667,14,0,49.731488605411975,13.6,0.12145414537831181
421,21,3,0.14285714285714285,18,0,21550.686571273647,15.857142857142858,0.1153632011304823
422,49,7,0.14285714285714285,42,0,49720.11066831194,27.714285714285715,0.12160913947861801
423,13,3,0.23076923076923078,10,0,12590.598786151615,23.615384615384617,0.15703003757419148
424,33,8,0.24242424242424243,25,0,73102.0548934942,21.606060606060606,0.13279722701089997
425,16,3,0.1875,13,0,41377.00967466061,22.125,0.11971142156796998
426,15,3,0.2,12,0,12.77230207433068,16.8,0.1169175448334143
427,19,4,0.21052631578947367,15,0,465.01717620240646,20.736842105263158,0.12062237760620727
428,22,5,0.22727272727272727,17,0,28371.583454617507,19.59090909090909,0.11742636169749611
429,39,9,0.23076923076923078,30,0,51815.98825389869,22.641025641025642,0.1194628577400974
430,11,3,0.2727272727272727,8,0,3370.282948303279,10.090909090909092,0.06669697577384426
431,19,5,0.2631578947368421,14,0,29118.818911673745,21.31578947368421,0.16007362342454737
432,12,3,0.25,9,0,48902.61500628898,24.166666666666668,0.13211815750763203
433,15,6,0.4,9,0,7276.869185144282,26.533333333333335,0.10785672016645872
434,37,8,0.21621621621621623,29,0,46957.56664566996,18.675675675675677,0.14125721973727068
435,21,4,0.19047619047619047,17,0,6601.17284516398,14.238095238095237,0.09987014531065817
436,17,3,0.17647058823529413,14,0,105073.7382867107,26.529411764705884,0.08032615279554237
437,12,2,0.16666666666666666,10,0,12380.277455015346,21.833333333333332,0.13446880694142738
438,19,5,0.2631578947368421,14,0,62586.27803126513,20.68421052631579,0.1143371078110344
439,20,2,0.1,18,0,4435.534176397383,15.65,0.1276772872271143
440,15,4,0.26666666666666666,11,0,226453.03161671103,45.6,0.17225077817539713
441,29,6,0.20689655172413793,23,0,116924.20235486876,28.03448275862069,0.1316678903354563
442,51,4,0.0784313725490196,47,0,9646.804693081891,14.254901960784315,0.12524951586133093
443,21,4,0.19047619047619047,17,0,51250.307387201625,22.761904761904763,0.13375821588756048
444,24,7,0.2916666666666667,17,0,2616.2100273037886,15.833333333333334,0.10187408872805047
445,24,6,0.25,18,0,102001.51964383556,20.5,0.11986266391457052
446,17,3,0.17647058823529413,14,0,64460.418894411465,15.882352941176471,0.13393774822952467
447,28,6,0.21428571428571427,22,0,59511.9914580556,21.321428571428573,0.13400073541546906
448,15,3,0.2,12,0,5839.554740294479,19.4,0.12192152464403218
449,11,3,0.2727272727272727,8,0,3277.41775785216,13.090909090909092,0.12121984791660577
450,13,3,0.23076923076923078,10,0,1164.3374294853634,10.846153846153847,0.11561612237342961
451,17,5,0.29411764705882354,12,0,122183.3139269733,21.58823529411765,0.14930014234386538
452,14,2,0.14285714285714285,12,0,86872.14350653483,15.714285714285714,0.08775786019603855
453,20,6,0.3,14,0,12639.22406789949,16.5,0.10435410794807394
454,14,1,0.07142857142857142,13,0,127104.19528412377,36.0,0.13021336175245815
455,11,2,0.18181818181818182,9,0,73178.96682372244,16.818181818181817,0.15480031289568738
456,31,5,0.16129032258064516,26,0,55993.7575418626,49.645161290322584,0.14137131277856912
457,13,1,0.07692307692307693,12,0,53494.27865481,21.923076923076923,0.1378910683692773
458,31,7,0.22580645161290322,24,0,49673.608940302016,17.70967741935484,0.1380207804645438
459,12,1,0.08333333333333333,11,0,43500.641303898454,10.75,0.0991888701637398
460,49,8,0.16326530612244897,41,0,18759.942309920785,19.571428571428573,0.1335898999450846
461,40,10,0.25,30,0,23966.801961876954,27.675,0.12789098147376543
462,12,1,0.08333333333333333,11,0,121.9247057742234,19.0,0.07585865263815039
463,13,2,0.15384615384615385,11,0,0.0,18.615384615384617,0.13398000798207194
464,22,3,0.13636363636363635,19,0,8266.003621724183,21.181818181818183,0.10657548289180974
465,24,2,0.08333333333333333,22,0,23170.666666666668,18.916666666666668,0.11701531788100228
466,27,10,0.37037037037037035,17,0,37187.517193525266,13.481481481481481,0.12234240315274378
467,16,2,0.125,14,0,0.0,18.0625,0.1289591949895963
468,11,3,0.2727272727272727,8,0,53828.62415164582,37.54545454545455,0.16810197254537476
469,24,4,0.16666666666666666,20,0,3481.422343243827,11.416666666666666,0.10129320082620728
470,22,5,0.22727272727272727,17,0,126704.0718813598,31.772727272727273,0.14315548905152362
471,23,8,0.34782608695652173,15,0,119510.65086490697,23.695652173913043,0.1298712871978473
472,16,2,0.125,14,0,34712.08898331667,36.125,0.14504212257869586
473,15,2,0.13333333333333333,13,0,2316.799999999999,13.666666666666666,0.10681063823630493
474,21,1,0.047619047619047616,20,0,6254.95853368733,18.952380952380953,0.13235104152447835
475,23,5,0.21739130434782608,18,0,19300.99714337126,11.173913043478262,0.11519822237698381
476,25,6,0.24,19,0,3339.1095849805483,19.4,0.13627560908527772
477,16,3,0.1875,13,0,9516.339227118468,31.0625,0.14360850992972632
478,15,2,0.13333333333333333,13,0,16280.640663784161,17.533333333333335,0.1423662920095106
479,35,7,0.2,28,0,8039.615895895813,18.228571428571428,0.13895991992583054
480,55,14,0.2545454545454545,41,0,7599.290459327764,17.236363636363638,0.11943359399230194
481,53,12,0.22641509433962265,41,0,55130.2515249044,15.358490566037736,0.09766791613384024
482,11,1,0.09090909090909091,10,0,1487.8064948102626,15.090909090909092,0.12450063727095693
483,18,2,0.1111111111111111,16,0,12404.690478633656,34.888888888888886,0.13210197995419704
484,13,3,0.23076923076923078,10,0,2682.0,16.153846153846153,0.1301632733863539
485,25,6,0.24,19,0,25915.15269466734,19.68,0.1563217569964123
486,15,3,0.2,12,0,134330.91383343283,24.6,0.1383047373614173
487,13,1,0.07692307692307693,12,0,20298.52142332564,37.46153846153846,0.1444414070986844
488,15,3,0.2,12,0,6254.403024302908,25.066666666666666,0.13472347597259604
489,29,5,0.1724137931034483,24,0,1490.9594383775484,17.379310344827587,0.1152127894736916
490,14,3,0.21428571428571427,11,0,56563.58323917945,32.357142857142854,0.1213575342628972
491,25,3,0.12,22,0,525.7742962893282,14.8,0.11655323584509217
492,22,2,0.09090909090909091,20,0,5126.428319330492,25.545454545454547,0.13947073971350413
493,13,0,0.0,13,0,48550.399060981035,24.153846153846153,0.10330361682054558
494,18,4,0.2222222222222222,14,0,2086.5056103690376,16.22222222222222,0.12650151180552807
495,13,3,0.23076923076923078,10,0,106614.01427925772,29.76923076923077,0.1511953194944528
496,17,4,0.23529411764705882,13,0,78548.26491051674,25.529411764705884,0.16183257045754337
497,14,2,0.14285714285714285,12,0,25840.622769608402,16.142857142857142,0.1298264420548097
498,27,2,0.07407407407407407,25,0,11471.936541485382,18.444444444444443,0.13425387754980894
499,18,4,0.2222222222222222,14,0,45712.717399745714,13.666666666666666,0.12627900612669132
500,11,4,0.36363636363636365,7,0,20355.702118118425,12.545454545454545,0.0850773018596521
501,18,4,0.2222222222222222,14,0,182044.3705885095,33.44444444444444,0.1377500102050553
502,14,2,0.14285714285714285,12,0,26603.421125851404,17.928571428571427,0.14864368945911902
503,12,4,0.3333333333333333,8,0,106772.50015137112,23.166666666666668,0.10339213422872355
504,31,4,0.12903225806451613,27,0,104.20806783300915,19.032258064516128,0.110466784023638
505,17,4,0.23529411764705882,13,0,33630.10147462207,31.176470588235293,0.16419413006738423
506,18,2,0.1111111111111111,16,0,42529.376778300364,21.5,0.11592828880336323
507,47,7,0.14893617021276595,40,0,43779.69113056628,26.06382978723404,0.13988668894018716
508,12,3,0.25,9,0,2126.4791959894706,16.416666666666668,0.14198394920017196
509,68,11,0.16176470588235295,57,0,156925.88207374397,22.0,0.11371930893692374
510,17,5,0.29411764705882354,12,0,0.0,14.941176470588236,0.12477668543723824
511,15,5,0.3333333333333333,10,0,34910.185239689235,24.6,0.1536150976284482
512,16,4,0.25,12,0,16373.022052497952,31.1875,0.13013676525068898
513,15,2,0.13333333333333333,13,0,149835.20729870562,46.86666666666667,0.12296179391868549
514,11,3,0.2727272727272727,8,0,52457.833530219265,16.454545454545453,0.0857999931189104
515,14,3,0.21428571428571427,11,0,0.0,21.214285714285715,0.13269650796638952
516,22,4,0.18181818181818182,18,0,63360.93588174283,24.045454545454547,0.11604318409095216
517,16,3,0.1875,13,0,69264.34462743708,22.9375,0.1278986780980928
518,13,3,0.23076923076923078,10,0,48924.59498257333,11.307692307692308,0.08514909612166585
519,34,7,0.20588235294117646,27,0,17047.917740127203,17.294117647058822,0.13920457291563423
520,13,2,0.15384615384615385,11,0,16035.643053000276,14.076923076923077,0.11895825231846323
521,42,9,0.21428571428571427,33,0,17619.549482710383,19.285714285714285,0.13648969656047058
522,12,1,0.08333333333333333,11,0,57828.170005791086,28.833333333333332,0.1357486052205336
523,27,6,0.2222222222222222,21,0,7218.274365617346,15.074074074074074,0.12166629185308643
524,14,1,0.07142857142857142,13,0,6344.416459636887,16.357142857142858,0.12753262086888045
525,11,3,0.2727272727272727,8,0,8257.18769013887,13.545454545454545,0.156533506104087
526,23,6,0.2608695652173913,17,0,117555.3429125241,33.91304347826087,0.1371665872052019
527,13,0,0.0,13,0,16409.167348407776,13.692307692307692,0.1255574862258334
528,14,4,0.2857142857142857,10,0,115.37321795797443,22.642857142857142,0.11950033064129838
529,28,4,0.14285714285714285,24,0,38701.85173908313,18.464285714285715,0.1430690343140375
530,40,10,0.25,30,0,6243.903179401331,21.15,0.12307080785081544
531,19,3,0.15789473684210525,16,0,79067.00328457946,40.68421052631579,0.16076314859163704
532,13,2,0.15384615384615385,11,0,33990.86259003582,14.76923076923077,0.1032830426596183
533,11,2,0.18181818181818182,9,0,0.10909090909090909,17.545454545454547,0.1448927177147805
534,22,7,0.3181818181818182,15,0,1735.594942199141,15.227272727272727,0.13275924284764942
535,43,9,0.20930232558139536,34,0,81222.55124752645,16.930232558139537,0.11312490985445307
536,18,2,0.1111111111111111,16,0,60572.88734153226,29.22222222222222,0.14009576064790694
537,11,1,0.09090909090909091,10,0,12148.63769716174,16.818181818181817,0.11069191040915931
538,47,11,0.23404255319148937,36,0,45475.01449805473,21.04255319148936,0.13210311005090544
539,15,3,0.2,12,0,430.59098134703135,15.133333333333333,0.13782885256402813
540,15,4,0.26666666666666666,11,0,1025.347446436389,16.266666666666666,0.09815118857224749
541,12,4,0.3333333333333333,8,0,7668.077696073854,16.666666666666668,0.11836659431150137
542,30,5,0.16666666666666666,25,0,60141.53068441311,16.3,0.10120994734268494
543,26,7,0.2692307692307692,19,0,148193.16133423455,18.653846153846153,0.08827535660002404
544,15,2,0.13333333333333333,13,0,102001.30782529156,13.733333333333333,0.12147498437218208
545,14,2,0.14285714285714285,12,0,16449.951368719427,20.714285714285715,0.09549377926842229
546,13,3,0.23076923076923078,10,0,1727.7141182687928,17.23076923076923,0.09573300032275744
547,20,6,0.3,14,0,73206.37335861812,21.5,0.14793245870283953
548,22,2,0.09090909090909091,20,0,38695.8115603308,28.5,0.1370330518196978
549,11,0,0.0,11,0,59297.87338609717,21.09090909090909,0.11039430535312561
550,11,3,0.2727272727272727,8,0,0.0,13.454545454545455,0.1261995519013136
551,22,4,0.18181818181818182,18,0,23034.316290019735,22.227272727272727,0.1303888073196444
552,25,4,0.16,21,0,18386.598819752104,19.04,0.14310645579356207
553,16,3,0.1875,13,0,18505.86321124852,17.8125,0.12233181864324466
554,13,1,0.07692307692307693,12,0,3986.5795282768927,19.615384615384617,0.13845636873176864
555,34,4,0.11764705882352941,30,0,85453.9770125414,16.294117647058822,0.07897667584565918
556,22,6,0.2727272727272727,16,0,5194.242755990728,21.272727272727273,0.1102533056475517
557,21,5,0.23809523809523808,16,0,98.19754590153492,15.047619047619047,0.13609871283395736
558,42,4,0.09523809523809523,38,0,19862.09476066401,22.047619047619047,0.11821895012729462
559,28,5,0.17857142857142858,23,0,85326.32975486117,28.178571428571427,0.13033502707722458
560,30,6,0.2,24,0,75614.15420950654,17.233333333333334,0.12438000390430573
561,13,3,0.23076923076923078,10,0,187.43889320738396,13.846153846153847,0.10252399197431418
562,16,3,0.1875,13,0,13757.376099371078,20.5,0.11870168419739816
563,17,3,0.17647058823529413,14,0,4091.529411764706,25.529411764705884,0.13172313500674654
564,14,4,0.2857142857142857,10,0,0.0,13.928571428571429,0.09005043259874017
565,19,5,0.2631578947368421,14,0,41019.18947827345,16.57894736842105,0.11156749565252576
566,20,3,0.15,17,0,38832.75118948708,32.35,0.15251701936892578
567,19,5,0.2631578947368421,14,0,2289.7840479361676,19.36842105263158,0.1301766982318435
568,13,0,0.0,13,0,7683.557064689304,22.615384615384617,0.16215935085373226
569,19,6,0.3157894736842105,13,0,1171.3247382796326,22.473684210526315,0.09767856606813306
570,11,3,0.2727272727272727,8,0,468.7586365930528,15.363636363636363,0.14101996595919677
571,13,4,0.3076923076923077,9,0,2675.8461538461543,11.23076923076923,0.12786741644311297
572,23,8,0.34782608695652173,15,0,14322.35878113939,27.565217391304348,0.14244415239413613
573,25,7,0.28,18,0,53067.39759077708,24.4,0.14203007522296013
574,18,7,0.3888888888888889,11,0,161753.0013863238,28.166666666666668,0.1459840301890956
575,16,4,0.25,12,0,3.779310271994243,15.4375,0.13777037393573666
576,11,1,0.09090909090909091,10,0,6716.332806314126,30.545454545454547,0.11421883174778644
577,11,2,0.18181818181818182,9,0,33274.277956133425,36.72727272727273,0.12329317353316181
578,11,4,0.36363636363636365,7,0,35454.12702693492,20.90909090909091,0.11034614242379552
579,22,6,0.2727272727272727,16,0,368485.3560795054,17.272727272727273,0.10076241398004977
580,19,4,0.21052631578947367,15,0,1329.6251993618744,14.421052631578947,0.12222777011388447
581,30,5,0.16666666666666666,25,0,11359.573252947792,15.833333333333334,0.13710971860417404
582,16,5,0.3125,11,0,1180.481605433076,14.5625,0.13758054506310183
583,26,4,0.15384615384615385,22,0,74759.90381544697,32.96153846153846,0.14594677543397164
584,33,9,0.2727272727272727,24,0,7161.233832408257,21.303030303030305,0.1027269506426747
585,16,5,0.3125,11,0,53007.668068789106,14.75,0.13126656615578547
586,14,3,0.21428571428571427,11,0,2393.4895188344694,19.5,0.10666742586604293
587,11,2,0.18181818181818182,9,0,0.8181818181818182,15.0,0.1308369647211722
588,17,4,0.23529411764705882,13,0,99801.75201779077,31.705882352941178,0.15704737154066606
589,47,7,0.14893617021276595,40,0,38812.474385895504,17.361702127659573,0.12551549281219088
590,19,3,0.15789473684210525,16,0,2398.0440754389374,13.105263157894736,0.10525167794444228
591,11,1,0.09090909090909091,10,0,0.0,11.727272727272727,0.1401059585235734
592,34,7,0.20588235294117646,27,0,22818.309157456995,17.294117647058822,0.11581130155763354
593,15,2,0.13333333333333333,13,0,40393.4863355635,31.133333333333333,0.15735476318511932
594,33,9,0.2727272727272727,24,0,43637.61945736653,16.696969696969695,0.11429111131890425
595,22,9,0.4090909090909091,13,0,122622.65087177507,30.818181818181817,0.15506784299503418
596,18,5,0.2777777777777778,13,0,6436.605756091688,17.22222222222222,0.12403506303942831
597,14,0,0.0,14,0,12663.01202711804,25.071428571428573,0.15719241426307096
598,17,1,0.058823529411764705,16,0,19164.049487349617,11.058823529411764,0.1330778090252253
599,12,4,0.3333333333333333,8,0,50204.848754709026,16.25,0.1200904446355479
600,14,4,0.2857142857142857,10,0,9401.290685434187,14.285714285714286,0.09280072526820236
601,11,3,0.2727272727272727,8,0,52175.85830977995,19.363636363636363,0.1548134800684511
602,33,5,0.15151515151515152,28,0,25395.036328989634,23.78787878787879,0.12136852174993526
603,13,3,0.23076923076923078,10,0,85514.85716147305,18.76923076923077,0.13508853365270687
604,25,4,0.16,21,0,4567.842592063867,17.68,0.12131884259244266
605,20,6,0.3,14,0,26068.51818181818,16.6,0.12918077026810487
606,23,6,0.2608695652173913,17,0,3318.7143434985956,12.26086956521739,0.11942891559041494
607,17,2,0.11764705882352941,15,0,31979.30201352366,16.058823529411764,0.13365193161146413
608,67,10,0.14925373134328357,57,0,147398.40218128424,18.29850746268657,0.11331576335513964
609,14,3,0.21428571428571427,11,0,168765.94613775742,27.142857142857142,0.12915769048788786
610,12,6,0.5,6,0,1227.4634071274097,18.25,0.13187982420811997
611,12,2,0.16666666666666666,10,0,481.0213490919309,6.083333333333333,0.12242816032225101
612,11,2,0.18181818181818182,9,0,24263.947439285625,67.81818181818181,0.17118427187985183
613,29,5,0.1724137931034483,24,0,4239.275681220425,12.89655172413793,0.11336761899531883
614,15,4,0.26666666666666666,11,0,28409.163418878492,17.533333333333335,0.10077906924022256
615,41,6,0.14634146341463414,35,0,16654.491014695905,15.292682926829269,0.11663154741616914
616,16,3,0.1875,13,0,6919.739456241239,42.375,0.1515916934256959
617,11,3,0.2727272727272727,8,0,31809.39417246293,11.181818181818182,0.11808701254257276
618,14,3,0.21428571428571427,11,0,0.0,16.714285714285715,0.13897843842851113
619,25,7,0.28,18,0,38941.00346540686,29.44,0.13586332411793356
620,26,4,0.15384615384615385,22,0,28597.165147740874,21.53846153846154,0.12488487641698603
621,23,7,0.30434782608695654,16,0,114924.08105464697,25.0,0.13895618184278105
622,15,5,0.3333333333333333,10,0,0.0,25.733333333333334,0.12166282498155077
623,14,3,0.21428571428571427,11,0,21811.22865680558,51.07142857142857,0.1291995380285849
624,16,4,0.25,12,0,38.99856294910753,18.875,0.14137811584716276
625,15,3,0.2,12,0,6297.002930172816,28.733333333333334,0.1344728800089395
626,17,5,0.29411764705882354,12,0,18.54047297418244,16.294117647058822,0.10887409637812358
627,28,8,0.2857142857142857,20,0,88581.59921992928,17.107142857142858,0.12849856514639657
628,41,8,0.1951219512195122,33,0,13580.216866927974,20.902439024390244,0.1234659885552395
629,39,9,0.23076923076923078,30,0,22571.273025315844,26.256410256410255,0.13446060287425882
630,28,6,0.21428571428571427,22,0,16008.204933770148,13.0,0.1440400194522112
631,29,5,0.1724137931034483,24,0,13803.031844435573,17.517241379310345,0.12073342565807145
632,14,2,0.14285714285714285,12,0,33545.53452327138,18.785714285714285,0.11037669544829513
633,46,11,0.2391304347826087,35,0,206282.72253120536,18.543478260869566,0.1137733560165998
634,14,4,0.2857142857142857,10,0,5.0,15.214285714285714,0.12244357668252932
635,12,5,0.4166666666666667,7,0,14490.833333333334,16.0,0.10638981106512584
636,21,4,0.19047619047619047,17,0,1716.9708968976365,28.61904761904762,0.13618400660492747
637,33,11,0.3333333333333333,22,0,14439.505223566994,14.93939393939394,0.11207720736454875
638,24,5,0.20833333333333334,19,0,0.0,19.666666666666668,0.1305713986266673
639,26,5,0.19230769230769232,21,0,36420.85640226909,22.23076923076923,0.14507046000015253
640,37,13,0.35135135135135137,24,0,50433.65578496276,27.89189189189189,0.12919731641440285
641,14,2,0.14285714285714285,12,0,35859.70292826048,21.928571428571427,0.13216490531785643
642,16,3,0.1875,13,0,232.51559523417103,11.0,0.1265821653219295
643,13,3,0.23076923076923078,10,0,12544.761585191563,24.076923076923077,0.13273030731802388
644,22,6,0.2727272727272727,16,0,2331.66373211812,15.454545454545455,0.11417334415626042
645,10,1,0.1,9,0,3615.934531642233,18.7,0.1562744449732077
646,16,2,0.125,14,0,47629.931182626766,18.25,0.11689793308915218
647,16,3,0.1875,13,0,347169.4978973786,21.6875,0.13699316697615815
648,31,2,0.06451612903225806,29,0,1596.1510051311584,14.774193548387096,0.11548314511683927
649,35,6,0.17142857142857143,29,0,15921.880173459505,18.2,0.13424195237955924
650,18,2,0.1111111111111111,16,0,8624.631562991965,22.444444444444443,0.12389610879219252
651,25,5,0.2,20,0,236471.93584296928,34.28,0.12622579100240863
652,11,3,0.2727272727272727,8,0,157627.96850274687,16.818181818181817,0.12274922401144511
653,80,13,0.1625,67,0,467232.915333073,30.3625,0.10165370829586876
654,15,4,0.26666666666666666,11,0,46211.71883922852,24.933333333333334,0.1332580643516197
655,18,4,0.2222222222222222,14,0,3.359386908439327,16.055555555555557,0.11929287506627745
656,15,3,0.2,12,0,4.737925208028747,13.466666666666667,0.1421011968919195
657,36,6,0.16666666666666666,30,0,1938.1944444444443,16.583333333333332,0.11960000176542882
658,12,4,0.3333333333333333,8,0,7.7777777777777795,11.75,0.14343550838335103
659,25,3,0.12,22,0,184.5155478448257,15.08,0.13564494717081843
660,20,3,0.15,17,0,50361.97875567193,17.0,0.13985745416396408
661,43,10,0.23255813953488372,33,0,107104.64820287799,21.790697674418606,0.12688166590425431
662,26,2,0.07692307692307693,24,0,715246.5393205633,26.615384615384617,0.13905437006207957
663,20,3,0.15,17,0,106390.62849324282,21.7,0.13886014625561838
664,32,12,0.375,20,0,89272.8381553229,27.125,0.15009069864572294
665,18,4,0.2222222222222222,14,0,62904.04887609083,26.77777777777778,0.14662394743498727
666,15,4,0.26666666666666666,11,0,85243.24017718188,15.866666666666667,0.13797940093928465
667,15,3,0.2,12,0,5264.14970652993,23.066666666666666,0.13701241865863564
668,34,10,0.29411764705882354,24,0,101760.70370553824,19.676470588235293,0.12529352074098918
669,27,5,0.18518518518518517,22,0,96752.43856920536,30.51851851851852,0.09328674990680366
670,16,3,0.1875,13,0,23962.481551996694,33.6875,0.11904217141785334
671,13,3,0.23076923076923078,10,0,42924.85317701144,17.846153846153847,0.12198874260868896
672,15,3,0.2,12,0,29838.90121697654,32.4,0.14534848191081123
673,12,7,0.5833333333333334,5,0,5.0,16.666666666666668,0.10502590407636675
674,24,3,0.125,21,0,108908.36984628327,23.875,0.1431163406194946
675,15,3,0.2,12,0,227980.60991513965,29.8,0.16384670950329594
676,13,3,0.23076923076923078,10,0,13376.153846153846,27.46153846153846,0.12252403277753651
677,21,7,0.3333333333333333,14,0,0.0,14.19047619047619,0.12948575378035024
678,38,7,0.18421052631578946,31,0,109634.88290713071,18.44736842105263,0.13137439985754504
679,13,2,0.15384615384615385,11,0,4.615384615384615,17.076923076923077,0.11219938526831968
680,36,9,0.25,27,0,76874.13055519604,11.88888888888889,0.08324442031440096
681,52,10,0.19230769230769232,42,0,143119.28276143453,29.653846153846153,0.14227657486298717
682,23,6,0.2608695652173913,17,0,2096.5631239058,21.347826086956523,0.11791658047075428
683,25,7,0.28,18,0,44739.82102853599,16.52,0.12496895823951279
684,18,4,0.2222222222222222,14,0,3124.175474915456,18.38888888888889,0.11934982851091348
685,29,7,0.2413793103448276,22,0,80738.32683223487,27.620689655172413,0.12878357464567114
686,19,1,0.05263157894736842,18,0,45629.969687030025,25.842105263157894,0.1303358360457855
687,31,4,0.12903225806451613,27,0,6486.034261763308,18.096774193548388,0.12777442192428146
688,26,9,0.34615384615384615,17,0,136.27269832501565,15.23076923076923,0.12190507336507712
689,20,2,0.1,18,0,35885.4754298898,16.0,0.12481734791032924
690,27,11,0.4074074074074074,16,0,19504.651982528398,23.555555555555557,0.11100290646844078
691,23,3,0.13043478260869565,20,0,42287.81713998638,18.869565217391305,0.14349290979879534
692,13,1,0.07692307692307693,12,0,14392.528302856936,17.846153846153847,0.130491788562763
693,43,3,0.06976744186046512,40,0,21023.854506525207,25.488372093023255,0.11022683979577733
694,27,6,0.2222222222222222,21,0,121850.59649685655,17.25925925925926,0.14889055959910455
695,14,4,0.2857142857142857,10,0,78053.65188511914,27.142857142857142,0.15802940545991845
696,16,6,0.375,10,0,76525.1575090026,35.8125,0.1403622356811347
697,12,0,0.0,12,0,0.023015873015873017,17.0,0.10867758678544058
698,29,3,0.10344827586206896,26,0,35315.20215597763,20.379310344827587,0.12110207916744721
699,13,0,0.0,13,0,25867.856203846226,20.923076923076923,0.10197953699069899
700,17,3,0.17647058823529413,14,0,50741.63961338412,27.647058823529413,0.14026950027287483
701,23,4,0.17391304347826086,19,0,77689.61412537006,23.52173913043478,0.13879333488538714
702,11,4,0.36363636363636365,7,0,30825.759787631432,31.272727272727273,0.14942737159291586
703,55,10,0.18181818181818182,45,0,88545.21612001662,22.69090909090909,0.1112194662826446
704,13,0,0.0,13,0,27391.7678448955,13.307692307692308,0.110573313821927
705,40,11,0.275,29,0,42920.845295691826,18.225,0.1286240144423064
706,12,4,0.3333333333333333,8,0,0.0,12.083333333333334,0.07960472925066978
707,20,7,0.35,13,0,26273.377629916686,26.1,0.1410170645146886
708,23,2,0.08695652173913043,21,0,88815.75549502188,18.869565217391305,0.1342872773432708
709,13,5,0.38461538461538464,8,0,153917.59442794436,15.846153846153847,0.14412157264771963
710,17,3,0.17647058823529413,14,0,142231.6922229196,30.88235294117647,0.15381124493347748
711,18,4,0.2222222222222222,14,0,476561.1354732265,31.38888888888889,0.15641291184579123
712,26,5,0.19230769230769232,21,0,41.55864911399211,19.96153846153846,0.12493879561578261
713,14,5,0.35714285714285715,9,0,103567.9574903586,16.214285714285715,0.11012787604372962
714,18,3,0.16666666666666666,15,0,65720.86198729374,23.055555555555557,0.11107204975818302
715,27,5,0.18518518518518517,22,0,51909.355037076486,23.51851851851852,0.1414492520720161
716,15,3,0.2,12,0,54783.721735560146,17.333333333333332,0.10386300243847031
717,13,2,0.15384615384615385,11,0,36100.93093193308,19.076923076923077,0.14254396137778105
718,15,4,0.26666666666666666,11,0,2165.4953877897774,12.133333333333333,0.10531386428735216
719,22,5,0.22727272727272727,17,0,1977.5407686721446,19.5,0.1011185771296428
720,14,4,0.2857142857142857,10,0,2009.4090557797203,16.642857142857142,0.15439061005755642
721,12,3,0.25,9,0,24926.01236170647,20.916666666666668,0.12760668228171318
722,16,1,0.0625,15,0,18993.372101948222,23.6875,0.1346039520068568
723,29,4,0.13793103448275862,25,0,9848.061057084302,18.0,0.1193917866237393
724,15,3,0.2,12,0,3000.630668727856,17.866666666666667,0.12935429298023035
725,17,4,0.23529411764705882,13,0,0.0,17.705882352941178,0.10801168396289601
726,14,5,0.35714285714285715,9,0,16440.826708657147,13.785714285714286,0.1269420951071436
727,19,4,0.21052631578947367,15,0,28227.197490078466,15.526315789473685,0.12125144182432591
728,16,2,0.125,14,0,1377.8653288712208,21.375,0.1271703222675355
729,23,4,0.17391304347826086,19,0,27427.906116168484,27.08695652173913,0.14962114788545697
730,11,3,0.2727272727272727,8,0,522.6485858447478,12.0,0.1411433551444765
731,18,3,0.16666666666666666,15,0,60576.134916334384,39.888888888888886,0.14481655505584148
732,13,3,0.23076923076923078,10,0,0.0,12.76923076923077,0.1110864806062131
733,18,3,0.16666666666666666,15,0,18.40204498232078,28.666666666666668,0.1346059824076921
734,11,5,0.45454545454545453,6,0,0.0,16.181818181818183,0.12388708884936536
735,12,1,0.08333333333333333,11,0,243.22653358229266,28.25,0.14605845990495522
736,13,3,0.23076923076923078,10,0,0.0,15.076923076923077,0.12526809481521134
737,13,1,0.07692307692307693,12,0,5302.378306852602,15.461538461538462,0.13795222830482967
738,12,3,0.25,9,0,27499.90190664702,16.833333333333332,0.10970319074921366
739,22,4,0.18181818181818182,18,0,5644.658983965379,20.363636363636363,0.11115784479393633
740,38,3,0.07894736842105263,35,0,5173.837620762785,28.894736842105264,0.15060188747864167
741,18,2,0.1111111111111111,16,0,2685.7339389583303,13.333333333333334,0.12780452770733391
742,40,7,0.175,33,0,13406.252407957421,16.5,0.10353141982661038
743,20,2,0.1,18,0,965.2039597447132,32.85,0.1256659865703304
744,14,1,0.07142857142857142,13,0,27634.249644854168,14.857142857142858,0.13319626747406654
745,13,2,0.15384615384615385,11,0,82805.24477164776,24.384615384615383,0.15141068836158295
746,16,3,0.1875,13,0,663.0710131656966,14.3125,0.13373685649417766
747,25,5,0.2,20,0,152882.75690470933,29.48,0.14069746362314806
748,48,13,0.2708333333333333,35,0,277602.62744042015,26.645833333333332,0.13833367436212407
749,11,1,0.09090909090909091,10,0,42112.27353339771,18.545454545454547,0.09935589304714276
750,27,7,0.25925925925925924,20,0,105438.3210192802,30.22222222222222,0.10063713182556801
751,13,0,0.0,13,0,4178.638389059885,23.23076923076923,0.14068680753416732
752,16,2,0.125,14,0,53469.26403707036,23.75,0.1316605198180597
753,14,4,0.2857142857142857,10,0,87715.5593914284,36.357142857142854,0.1368799927871171
754,11,3,0.2727272727272727,8,0,28675.750889446717,25.636363636363637,0.14245083496145433
755,36,8,0.2222222222222222,28,0,98454.36403778137,27.36111111111111,0.12821259605089413
756,11,5,0.45454545454545453,6,0,69203.30022206888,44.63636363636363,0.1377077378333282
757,25,2,0.08,23,0,10259.887954979027,21.72,0.12575329610594982
758,23,4,0.17391304347826086,19,0,55013.61961871407,25.47826086956522,0.15339179500640346
759,16,6,0.375,10,0,79842.04835292182,19.25,0.13193458294380184
760,55,15,0.2727272727272727,40,0,95590.03771795283,27.436363636363637,0.12886977853915196
761,30,7,0.23333333333333334,23,0,3584.7428649738363,16.966666666666665,0.13503791861257822
762,13,3,0.23076923076923078,10,0,0.0,16.53846153846154,0.11658039778457954
763,41,6,0.14634146341463414,35,0,80336.0975798927,31.097560975609756,0.13669972425163526
764,11,1,0.09090909090909091,10,0,50155.76185135613,19.181818181818183,0.0843731226579107
765,34,8,0.23529411764705882,26,0,22928.804236731845,16.264705882352942,0.12476447246052862
766,22,3,0.13636363636363635,19,0,264340.6074083197,20.181818181818183,0.12539053620643206
767,23,7,0.30434782608695654,16,0,55925.27899547399,17.304347826086957,0.11461257442072423
768,16,4,0.25,12,0,28775.78200183024,26.1875,0.14655715764797667
769,11,3,0.2727272727272727,8,0,0.0,12.545454545454545,0.10623082061095891
770,16,1,0.0625,15,0,135690.61731786717,57.8125,0.1352747703469236
771,12,0,0.0,12,0,365346.32360353967,36.5,0.15244308758596237
772,20,5,0.25,15,0,89439.82726611177,34.8,0.14044452509155
773,13,3,0.23076923076923078,10,0,0.0,18.153846153846153,0.1337360328590951
774,19,5,0.2631578947368421,14,0,5470.67201919502,31.789473684210527,0.16467010523576772
775,19,5,0.2631578947368421,14,0,81022.78610294142,17.31578947368421,0.1328753244722735
776,16,4,0.25,12,0,12895.620464396803,17.0625,0.12860565662217935
777,29,5,0.1724137931034483,24,0,115078.09789748766,29.413793103448278,0.138934990331891
778,26,3,0.11538461538461539,23,0,71939.71202356536,32.42307692307692,0.13569710256963957
779,12,1,0.08333333333333333,11,0,55.77777777777777,18.083333333333332,0.1068149764416087
780,29,10,0.3448275862068966,19,0,66326.34090940098,37.03448275862069,0.14091298995216486
781,12,3,0.25,9,0,35684.64008544585,18.5,0.10930301573622875
782,27,6,0.2222222222222222,21,0,8431.568672790261,17.74074074074074,0.08831622801469033
783,20,0,0.0,20,0,50635.66119966572,46.05,0.15467194034869602
784,24,4,0.16666666666666666,20,0,83279.36919637097,18.291666666666668,0.13484167210687148
785,17,1,0.058823529411764705,16,0,12429.510992291178,20.176470588235293,0.12566507610396926
786,33,6,0.18181818181818182,27,0,51267.39554531818,18.666666666666668,0.12993225778040812
787,14,3,0.21428571428571427,11,0,22840.80951433335,17.785714285714285,0.1531510355683788
788,30,8,0.26666666666666666,22,0,32904.18516727642,18.766666666666666,0.12794989591681108
789,12,4,0.3333333333333333,8,0,39232.55742828278,31.083333333333332,0.1490879859792498
790,13,3,0.23076923076923078,10,0,86211.53762634966,18.384615384615383,0.14384435517874639
791,12,4,0.3333333333333333,8,0,3814.5242794948335,14.333333333333334,0.10616474837377175
792,12,3,0.25,9,0,35827.135295660824,15.916666666666666,0.13091836726774203
793,17,1,0.058823529411764705,16,0,43692.814371872715,27.41176470588235,0.11219705116420643
794,11,2,0.18181818181818182,9,0,3878.0507175783846,11.454545454545455,0.14865875768606257
795,30,4,0.13333333333333333,26,0,83060.2232886829,18.133333333333333,0.11615216842088415
796,12,4,0.3333333333333333,8,0,16585.850030951708,15.583333333333334,0.1262245439702671
797,19,3,0.15789473684210525,16,0,27760.909337715253,17.31578947368421,0.11762326612412502
798,35,3,0.08571428571428572,32,0,64542.12516926422,22.514285714285716,0.14124195320183905
799,11,2,0.18181818181818182,9,0,54317.42710655595,19.0,0.16903374955709824
800,23,3,0.13043478260869565,20,0,149224.6925208786,33.95652173913044,0.16679729446734623
801,23,6,0.2608695652173913,17,0,48078.942791943366,21.17391304347826,0.12301947600091677
802,13,4,0.3076923076923077,9,0,9404.898281866987,20.76923076923077,0.1607950762202706
803,37,6,0.16216216216216217,31,0,2548.7212927615637,19.64864864864865,0.12830281452197687
804,27,8,0.2962962962962963,19,0,8297.408660583493,15.62962962962963,0.12823368022248
805,11,1,0.09090909090909091,10,0,31353.5716317802,21.363636363636363,0.160176570027063
806,14,5,0.35714285714285715,9,0,104373.55791289335,23.571428571428573,0.16074640310283564
807,12,3,0.25,9,0,19058.39407448596,16.75,0.12465324510149774
808,88,18,0.20454545454545456,70,0,199302.69402514322,24.65909090909091,0.12193608140474889
809,11,2,0.18181818181818182,9,0,2481.5760153371903,35.45454545454545,0.113706584980116
810,11,5,0.45454545454545453,6,0,78554.52162762116,21.636363636363637,0.13020986685099853
811,11,2,0.18181818181818182,9,0,2722.8280326497143,15.545454545454545,0.08773031857319333
812,21,8,0.38095238095238093,13,0,360168.97930282576,26.285714285714285,0.11825341983770957
813,69,17,0.2463768115942029,52,0,98525.07969117923,19.27536231884058,0.11284818631185688
814,15,3,0.2,12,0,51406.76016422567,18.133333333333333,0.1303591916265216
815,12,1,0.08333333333333333,11,0,72590.91785529836,13.0,0.09541922617342173
816,15,3,0.2,12,0,114069.25301473071,25.266666666666666,0.1498902464209969
817,13,5,0.38461538461538464,8,0,4.651458796300607,11.692307692307692,0.13924521476162702
818,12,4,0.3333333333333333,8,0,90453.6886328666,27.75,0.13599499159217726
819,11,4,0.36363636363636365,7,0,26999.482761942745,20.545454545454547,0.14373890580587415
820,151,31,0.2052980132450331,120,0,300250.293260229,19.192052980132452,0.14091065784290266
821,15,6,0.4,9,0,65682.32784944483,35.53333333333333,0.1602702266023056
822,12,2,0.16666666666666666,10,0,40002.10817496836,32.166666666666664,0.14882076285854565
823,12,2,0.16666666666666666,10,0,44985.30216801199,29.166666666666668,0.14444349095160045
824,11,2,0.18181818181818182,9,0,30002.312214722588,17.272727272727273,0.12299259842355678
825,11,1,0.09090909090909091,10,0,29393.67390773157,43.36363636363637,0.15920919883865442
826,11,2,0.18181818181818182,9,0,38024.8686602648,35.63636363636363,0.15776583217833107
827,166,24,0.14457831325301204,142,0,61581.55283996218,29.771084337349397,0.1394927552495858
828,15,3,0.2,12,0,21509.866964302964,44.266666666666666,0.15454043480269417
829,20,5,0.25,15,0,5390.4381717503275,17.8,0.11610765943998488
830,19,4,0.21052631578947367,15,0,80312.59717479635,25.789473684210527,0.11381062171304908
831,21,3,0.14285714285714285,18,0,41763.30263145462,60.19047619047619,0.1611537027913275
832,12,3,0.25,9,0,75365.76894638188,34.25,0.13131906608196048
833,12,3,0.25,9,0,56573.63747781808,11.25,0.14622022985037028
834,194,25,0.12886597938144329,169,0,17844.905655484952,29.3659793814433,0.1314133468280001
835,61,10,0.16393442622950818,51,0,74041.09302980518,24.459016393442624,0.14156810420534133
836,23,3,0.13043478260869565,20,0,62771.47809458206,35.08695652173913,0.14716756350165638
837,17,2,0.11764705882352941,15,0,55826.72264291899,35.411764705882355,0.1520548227671573
